level-4-expr	{ }
iomsg-variable	{ }
NAME_LITERAL15_opt_autogen	{ FORMAT ENTRY DATA ALLOCATE NAME_LITERAL BACKSPACE CALL CLOSE CONTINUE CYCLE DEALLOCATE END ENDFILE ERROR_STOP EXIT FLUSH FORALL GO_TO IF INQUIRE LOCK NULLIFY OPEN PRINT READ RETURN REWIND STOP SYNC_ALL SYNC_IMAGES SYNC_MEMORY UNLOCK WAIT WHERE WRITE INT_LITERAL_CONSTANT REAL_LITERAL_CONSTANT COMPLEX_LITERAL_CONSTANT LOGICAL_LITERAL_CONSTANT CHAR_LITERAL_CONSTANT BOZ_LITERAL_CONSTANT }
nonblock-do-construct	{ FORMAT ENTRY DATA ALLOCATE NAME_LITERAL BACKSPACE CALL CLOSE CONTINUE CYCLE DEALLOCATE END ENDFILE ERROR_STOP EXIT FLUSH FORALL GO_TO IF INQUIRE LOCK NULLIFY OPEN PRINT READ RETURN REWIND STOP SYNC_ALL SYNC_IMAGES SYNC_MEMORY UNLOCK WAIT WHERE WRITE INT_LITERAL_CONSTANT REAL_LITERAL_CONSTANT COMPLEX_LITERAL_CONSTANT LOGICAL_LITERAL_CONSTANT CHAR_LITERAL_CONSTANT BOZ_LITERAL_CONSTANT }
function-subprogram	{ PROGRAM MODULE SUBMODULE BLOCK_DATA 'TYPE' 'CLASS' ELEMENTAL IMPURE PURE RECURSIVE INTEGER REAL DOUBLE_PRECISION COMPLEX CHARACTER LOGICAL MODULE_PROCEDURE }
104_group_autogen	{ }
dummy-arg	{ ')' }
proc-language-binding-spec	{ RESULT }
sync-stat	{ ')' }
NAME_LITERAL8_opt_autogen	{ FORMAT ENTRY DATA ALLOCATE NAME_LITERAL BACKSPACE CALL CLOSE CONTINUE CYCLE DEALLOCATE END ENDFILE ERROR_STOP EXIT FLUSH FORALL GO_TO IF INQUIRE LOCK NULLIFY OPEN PRINT READ RETURN REWIND STOP SYNC_ALL SYNC_IMAGES SYNC_MEMORY UNLOCK WAIT WHERE WRITE INT_LITERAL_CONSTANT REAL_LITERAL_CONSTANT COMPLEX_LITERAL_CONSTANT LOGICAL_LITERAL_CONSTANT CHAR_LITERAL_CONSTANT BOZ_LITERAL_CONSTANT }
63_group_autogen	{ NAME_LITERAL }
type-param-attr-spec	{ ':' }
substring	{ ',' '%' '*' }
proc-target	{ FORMAT ENTRY DATA ALLOCATE NAME_LITERAL BACKSPACE CALL CLOSE CONTINUE CYCLE DEALLOCATE END ENDFILE ERROR_STOP EXIT FLUSH FORALL GO_TO IF INQUIRE LOCK NULLIFY OPEN PRINT READ RETURN REWIND STOP SYNC_ALL SYNC_IMAGES SYNC_MEMORY UNLOCK WAIT WHERE WRITE INT_LITERAL_CONSTANT REAL_LITERAL_CONSTANT COMPLEX_LITERAL_CONSTANT LOGICAL_LITERAL_CONSTANT CHAR_LITERAL_CONSTANT BOZ_LITERAL_CONSTANT }
io-implied-do-object	{ ',' }
binding-private-stmt	{ }
v-list	{ ')' }
127_opt_autogen	{ PROGRAM MODULE SUBMODULE BLOCK_DATA 'TYPE' 'CLASS' ELEMENTAL IMPURE PURE RECURSIVE INTEGER REAL DOUBLE_PRECISION COMPLEX CHARACTER LOGICAL }
207_group_autogen	{ ',' }
type-param-def-stmt	{ INTEGER }
flush-spec	{ ')' }
MODULE1_opt_autogen	{ PROCEDURE }
data-stmt-repeat	{ '*' }
bind-entity	{ ENTRY FORMAT PARAMETER PROCEDURE 'TYPE' 'CLASS' NAME_LITERAL ENUM INTERFACE ABSTRACT_INTERFACE PUBLIC PRIVATE ALLOCATABLE ASYNCHRONOUS BIND CODIMENSION COMMON DATA DIMENSION EQUIVALENCE EXTERNAL INTENT INTRINSIC NAMELIST OPTIONAL POINTER PROTECTED SAVE TARGET VOLATILE VALUE INTEGER REAL DOUBLE_PRECISION COMPLEX CHARACTER LOGICAL }
data-stmt-constant	{ }
31_optlist_autogen	{ ',' ENTRY FORMAT PARAMETER PROCEDURE 'TYPE' 'CLASS' NAME_LITERAL ENUM INTERFACE ABSTRACT_INTERFACE PUBLIC PRIVATE ALLOCATABLE ASYNCHRONOUS BIND CODIMENSION COMMON DATA DIMENSION EQUIVALENCE EXTERNAL INTENT INTRINSIC NAMELIST OPTIONAL POINTER PROTECTED SAVE TARGET VOLATILE VALUE INTEGER REAL DOUBLE_PRECISION COMPLEX CHARACTER LOGICAL }
122_opt_autogen	{ ',' ')' }
113_group_autogen	{ ',' }
logical-literal-constant	{ }
82_group_autogen	{ ',' }
association-list	{ ')' }
selector	{ ')' }
data-implied-do	{ }
12_optlist_autogen	{ ',' ENUMERATOR END_ENUM }
r	{ 'I' 'B' 'O' 'Z' 'F' 'E' 'EN' 'ES' 'G' 'L' 'A' 'D' 'DT' '(' '/' }
64_optlist_autogen	{ ',' ')' }
if-then-stmt	{ }
152_group_autogen	{ END_IF }
27_group_autogen	{ }
actual-arg-spec	{ ')' }
22_opt_autogen	{ }
r2_opt_autogen	{ '(' }
NAME_LITERAL9_opt_autogen	{ FORMAT ENTRY DATA ALLOCATE NAME_LITERAL BACKSPACE CALL CLOSE CONTINUE CYCLE DEALLOCATE END ENDFILE ERROR_STOP EXIT FLUSH FORALL GO_TO IF INQUIRE LOCK NULLIFY OPEN PRINT READ RETURN REWIND STOP SYNC_ALL SYNC_IMAGES SYNC_MEMORY UNLOCK WAIT WHERE WRITE INT_LITERAL_CONSTANT REAL_LITERAL_CONSTANT COMPLEX_LITERAL_CONSTANT LOGICAL_LITERAL_CONSTANT CHAR_LITERAL_CONSTANT BOZ_LITERAL_CONSTANT }
parameter-stmt	{ IMPLICIT IMPLICIT_NONE PARAMETER FORMAT ENTRY PROCEDURE 'TYPE' 'CLASS' NAME_LITERAL ENUM INTERFACE ABSTRACT_INTERFACE PUBLIC PRIVATE ALLOCATABLE ASYNCHRONOUS BIND CODIMENSION COMMON DATA DIMENSION EQUIVALENCE EXTERNAL INTENT INTRINSIC NAMELIST OPTIONAL POINTER PROTECTED SAVE TARGET VOLATILE VALUE INTEGER REAL DOUBLE_PRECISION COMPLEX CHARACTER LOGICAL }
array-section	{ '%' '*' }
type-declaration-stmt	{ ENTRY FORMAT PARAMETER PROCEDURE 'TYPE' 'CLASS' NAME_LITERAL ENUM INTERFACE ABSTRACT_INTERFACE PUBLIC PRIVATE ALLOCATABLE ASYNCHRONOUS BIND CODIMENSION COMMON DATA DIMENSION EQUIVALENCE EXTERNAL INTENT INTRINSIC NAMELIST OPTIONAL POINTER PROTECTED SAVE TARGET VOLATILE VALUE INTEGER REAL DOUBLE_PRECISION COMPLEX CHARACTER LOGICAL }
96_group_autogen	{ ',' }
213_group_autogen	{ NAME_LITERAL }
85_opt_autogen	{ NAME_LITERAL }
205_group_autogen	{ ':' NAME_LITERAL }
','3_opt_autogen	{ '/' }
r1_opt_autogen	{ 'I' 'B' 'O' 'Z' 'F' 'E' 'EN' 'ES' 'G' 'L' 'A' 'D' 'DT' }
9_opt_autogen	{ '[' }
bounds-spec	{ ')' }
','1_opt_autogen	{ }
error-stop-stmt	{ FORMAT ENTRY DATA ALLOCATE NAME_LITERAL BACKSPACE CALL CLOSE CONTINUE CYCLE DEALLOCATE END ENDFILE ERROR_STOP EXIT FLUSH FORALL GO_TO IF INQUIRE LOCK NULLIFY OPEN PRINT READ RETURN REWIND STOP SYNC_ALL SYNC_IMAGES SYNC_MEMORY UNLOCK WAIT WHERE WRITE INT_LITERAL_CONSTANT REAL_LITERAL_CONSTANT COMPLEX_LITERAL_CONSTANT LOGICAL_LITERAL_CONSTANT CHAR_LITERAL_CONSTANT BOZ_LITERAL_CONSTANT }
25_optlist_autogen	{ ',' ENTRY FORMAT PARAMETER PROCEDURE 'TYPE' 'CLASS' NAME_LITERAL ENUM INTERFACE ABSTRACT_INTERFACE PUBLIC PRIVATE ALLOCATABLE ASYNCHRONOUS BIND CODIMENSION COMMON DATA DIMENSION EQUIVALENCE EXTERNAL INTENT INTRINSIC NAMELIST OPTIONAL POINTER PROTECTED SAVE TARGET VOLATILE VALUE INTEGER REAL DOUBLE_PRECISION COMPLEX CHARACTER LOGICAL }
intrinsic-stmt	{ ENTRY FORMAT PARAMETER PROCEDURE 'TYPE' 'CLASS' NAME_LITERAL ENUM INTERFACE ABSTRACT_INTERFACE PUBLIC PRIVATE ALLOCATABLE ASYNCHRONOUS BIND CODIMENSION COMMON DATA DIMENSION EQUIVALENCE EXTERNAL INTENT INTRINSIC NAMELIST OPTIONAL POINTER PROTECTED SAVE TARGET VOLATILE VALUE INTEGER REAL DOUBLE_PRECISION COMPLEX CHARACTER LOGICAL }
specification-part3_opt_autogen	{ CONTAINS }
control-edit-desc	{ ',' ')' }
variable	{ '=' '%' ',' ')' FORMAT ENTRY DATA ALLOCATE NAME_LITERAL BACKSPACE CALL CLOSE CONTINUE CYCLE DEALLOCATE END ENDFILE ERROR_STOP EXIT FLUSH FORALL GO_TO IF INQUIRE LOCK NULLIFY OPEN PRINT READ RETURN REWIND STOP SYNC_ALL SYNC_IMAGES SYNC_MEMORY UNLOCK WAIT WHERE WRITE INT_LITERAL_CONSTANT REAL_LITERAL_CONSTANT COMPLEX_LITERAL_CONSTANT LOGICAL_LITERAL_CONSTANT CHAR_LITERAL_CONSTANT BOZ_LITERAL_CONSTANT }
52_group_autogen	{ }
common-block-object	{ ENTRY FORMAT PARAMETER PROCEDURE 'TYPE' 'CLASS' NAME_LITERAL ENUM INTERFACE ABSTRACT_INTERFACE PUBLIC PRIVATE ALLOCATABLE ASYNCHRONOUS BIND CODIMENSION COMMON DATA DIMENSION EQUIVALENCE EXTERNAL INTENT INTRINSIC NAMELIST OPTIONAL POINTER PROTECTED SAVE TARGET VOLATILE VALUE INTEGER REAL DOUBLE_PRECISION COMPLEX CHARACTER LOGICAL }
equiv-op	{ }
do-stmt	{ }
68_group_autogen	{ NAME_LITERAL }
NAME_LITERAL27_opt_autogen	{ }
derived-type-def	{ ENTRY FORMAT PARAMETER PROCEDURE 'TYPE' 'CLASS' NAME_LITERAL ENUM INTERFACE ABSTRACT_INTERFACE PUBLIC PRIVATE ALLOCATABLE ASYNCHRONOUS BIND CODIMENSION COMMON DATA DIMENSION EQUIVALENCE EXTERNAL INTENT INTRINSIC NAMELIST OPTIONAL POINTER PROTECTED SAVE TARGET VOLATILE VALUE INTEGER REAL DOUBLE_PRECISION COMPLEX CHARACTER LOGICAL }
16_opt_autogen	{ }
lower-bound1_opt_autogen	{ ':' }
entity-decl	{ ENTRY FORMAT PARAMETER PROCEDURE 'TYPE' 'CLASS' NAME_LITERAL ENUM INTERFACE ABSTRACT_INTERFACE PUBLIC PRIVATE ALLOCATABLE ASYNCHRONOUS BIND CODIMENSION COMMON DATA DIMENSION EQUIVALENCE EXTERNAL INTENT INTRINSIC NAMELIST OPTIONAL POINTER PROTECTED SAVE TARGET VOLATILE VALUE INTEGER REAL DOUBLE_PRECISION COMPLEX CHARACTER LOGICAL }
155_group_autogen	{ SELECT_CASE }
bounds-spec-list	{ ')' }
134_opt_autogen	{ NAME_LITERAL }
forall-construct	{ FORMAT ENTRY DATA ALLOCATE NAME_LITERAL BACKSPACE CALL CLOSE CONTINUE CYCLE DEALLOCATE END ENDFILE ERROR_STOP EXIT FLUSH FORALL GO_TO IF INQUIRE LOCK NULLIFY OPEN PRINT READ RETURN REWIND STOP SYNC_ALL SYNC_IMAGES SYNC_MEMORY UNLOCK WAIT WHERE WRITE INT_LITERAL_CONSTANT REAL_LITERAL_CONSTANT COMPLEX_LITERAL_CONSTANT LOGICAL_LITERAL_CONSTANT CHAR_LITERAL_CONSTANT BOZ_LITERAL_CONSTANT END_FORALL }
expr3_opt_autogen	{ FORMAT ENTRY DATA ALLOCATE NAME_LITERAL BACKSPACE CALL CLOSE CONTINUE CYCLE DEALLOCATE END ENDFILE ERROR_STOP EXIT FLUSH FORALL GO_TO IF INQUIRE LOCK NULLIFY OPEN PRINT READ RETURN REWIND STOP SYNC_ALL SYNC_IMAGES SYNC_MEMORY UNLOCK WAIT WHERE WRITE INT_LITERAL_CONSTANT REAL_LITERAL_CONSTANT COMPLEX_LITERAL_CONSTANT LOGICAL_LITERAL_CONSTANT CHAR_LITERAL_CONSTANT BOZ_LITERAL_CONSTANT }
type-param-spec-list	{ ')' }
154_group_autogen	{ CASE END_SELECT }
135_group_autogen	{ ',' }
input-item-list1_opt_autogen	{ FORMAT ENTRY DATA ALLOCATE NAME_LITERAL BACKSPACE CALL CLOSE CONTINUE CYCLE DEALLOCATE END ENDFILE ERROR_STOP EXIT FLUSH FORALL GO_TO IF INQUIRE LOCK NULLIFY OPEN PRINT READ RETURN REWIND STOP SYNC_ALL SYNC_IMAGES SYNC_MEMORY UNLOCK WAIT WHERE WRITE INT_LITERAL_CONSTANT REAL_LITERAL_CONSTANT COMPLEX_LITERAL_CONSTANT LOGICAL_LITERAL_CONSTANT CHAR_LITERAL_CONSTANT BOZ_LITERAL_CONSTANT }
named-constant-def-list	{ ')' }
upper-bound	{ ',' }
NAME_LITERAL13_opt_autogen	{ }
n	{ 'X' ',' ')' }
195_group_autogen	{ }
ac-value	{ ',' '/' ']' }
kind-selector1_opt_autogen	{ ')' ':' ',' '(' }
61_optlist_autogen	{ ',' ')' }
2_group_autogen	{ }
132_group_autogen	{ }
NAME_LITERAL19_opt_autogen	{ }
95_group_autogen	{ ',' }
block-data-stmt	{ }
158_group_autogen	{ SELECT }
where-construct	{ FORMAT ENTRY DATA ALLOCATE NAME_LITERAL BACKSPACE CALL CLOSE CONTINUE CYCLE DEALLOCATE END ENDFILE ERROR_STOP EXIT FLUSH FORALL GO_TO IF INQUIRE LOCK NULLIFY OPEN PRINT READ RETURN REWIND STOP SYNC_ALL SYNC_IMAGES SYNC_MEMORY UNLOCK WAIT WHERE WRITE INT_LITERAL_CONSTANT REAL_LITERAL_CONSTANT COMPLEX_LITERAL_CONSTANT LOGICAL_LITERAL_CONSTANT CHAR_LITERAL_CONSTANT BOZ_LITERAL_CONSTANT END_FORALL }
close-spec	{ ')' }
volatile-stmt	{ ENTRY FORMAT PARAMETER PROCEDURE 'TYPE' 'CLASS' NAME_LITERAL ENUM INTERFACE ABSTRACT_INTERFACE PUBLIC PRIVATE ALLOCATABLE ASYNCHRONOUS BIND CODIMENSION COMMON DATA DIMENSION EQUIVALENCE EXTERNAL INTENT INTRINSIC NAMELIST OPTIONAL POINTER PROTECTED SAVE TARGET VOLATILE VALUE INTEGER REAL DOUBLE_PRECISION COMPLEX CHARACTER LOGICAL }
coarray-spec	{ ']' }
86_group_autogen	{ NAME_LITERAL }
219_group_autogen	{ }
if-stmt	{ FORMAT ENTRY DATA ALLOCATE NAME_LITERAL BACKSPACE CALL CLOSE CONTINUE CYCLE DEALLOCATE END ENDFILE ERROR_STOP EXIT FLUSH FORALL GO_TO IF INQUIRE LOCK NULLIFY OPEN PRINT READ RETURN REWIND STOP SYNC_ALL SYNC_IMAGES SYNC_MEMORY UNLOCK WAIT WHERE WRITE INT_LITERAL_CONSTANT REAL_LITERAL_CONSTANT COMPLEX_LITERAL_CONSTANT LOGICAL_LITERAL_CONSTANT CHAR_LITERAL_CONSTANT BOZ_LITERAL_CONSTANT }
submodule	{ PROGRAM MODULE SUBMODULE BLOCK_DATA 'TYPE' 'CLASS' ELEMENTAL IMPURE PURE RECURSIVE INTEGER REAL DOUBLE_PRECISION COMPLEX CHARACTER LOGICAL }
rewind-stmt	{ FORMAT ENTRY DATA ALLOCATE NAME_LITERAL BACKSPACE CALL CLOSE CONTINUE CYCLE DEALLOCATE END ENDFILE ERROR_STOP EXIT FLUSH FORALL GO_TO IF INQUIRE LOCK NULLIFY OPEN PRINT READ RETURN REWIND STOP SYNC_ALL SYNC_IMAGES SYNC_MEMORY UNLOCK WAIT WHERE WRITE INT_LITERAL_CONSTANT REAL_LITERAL_CONSTANT COMPLEX_LITERAL_CONSTANT LOGICAL_LITERAL_CONSTANT CHAR_LITERAL_CONSTANT BOZ_LITERAL_CONSTANT }
dummy-arg-list1_opt_autogen	{ ')' }
case-value	{ ':' }
105_opt_autogen	{ }
forall-step	{ }
action-term-do-construct	{ FORMAT ENTRY DATA ALLOCATE NAME_LITERAL BACKSPACE CALL CLOSE CONTINUE CYCLE DEALLOCATE END ENDFILE ERROR_STOP EXIT FLUSH FORALL GO_TO IF INQUIRE LOCK NULLIFY OPEN PRINT READ RETURN REWIND STOP SYNC_ALL SYNC_IMAGES SYNC_MEMORY UNLOCK WAIT WHERE WRITE INT_LITERAL_CONSTANT REAL_LITERAL_CONSTANT COMPLEX_LITERAL_CONSTANT LOGICAL_LITERAL_CONSTANT CHAR_LITERAL_CONSTANT BOZ_LITERAL_CONSTANT }
derived-type-spec	{ ')' '(' ':' }
110_group_autogen	{ ',' }
codimension-stmt	{ ENTRY FORMAT PARAMETER PROCEDURE 'TYPE' 'CLASS' NAME_LITERAL ENUM INTERFACE ABSTRACT_INTERFACE PUBLIC PRIVATE ALLOCATABLE ASYNCHRONOUS BIND CODIMENSION COMMON DATA DIMENSION EQUIVALENCE EXTERNAL INTENT INTRINSIC NAMELIST OPTIONAL POINTER PROTECTED SAVE TARGET VOLATILE VALUE INTEGER REAL DOUBLE_PRECISION COMPLEX CHARACTER LOGICAL }
wait-stmt	{ FORMAT ENTRY DATA ALLOCATE NAME_LITERAL BACKSPACE CALL CLOSE CONTINUE CYCLE DEALLOCATE END ENDFILE ERROR_STOP EXIT FLUSH FORALL GO_TO IF INQUIRE LOCK NULLIFY OPEN PRINT READ RETURN REWIND STOP SYNC_ALL SYNC_IMAGES SYNC_MEMORY UNLOCK WAIT WHERE WRITE INT_LITERAL_CONSTANT REAL_LITERAL_CONSTANT COMPLEX_LITERAL_CONSTANT LOGICAL_LITERAL_CONSTANT CHAR_LITERAL_CONSTANT BOZ_LITERAL_CONSTANT }
component-array-spec	{ ')' }
141_group_autogen	{ ')' }
internal-subprogram	{ 'TYPE' 'CLASS' ELEMENTAL IMPURE MODULE PURE RECURSIVE INTEGER REAL DOUBLE_PRECISION COMPLEX CHARACTER LOGICAL }
char-length	{ ',' }
29_opt_autogen	{ ')' }
102_opt_autogen	{ ')' }
102_group_autogen	{ }
6_optlist_autogen	{ ',' 'TYPE' 'CLASS' PROCEDURE INTEGER REAL DOUBLE_PRECISION COMPLEX CHARACTER LOGICAL }
specification-part8_opt_autogen	{ ALLOCATE NAME_LITERAL BACKSPACE CALL CLOSE CONTINUE CYCLE DEALLOCATE END ENDFILE ERROR_STOP EXIT FLUSH FORALL GO_TO IF INQUIRE LOCK NULLIFY OPEN PRINT READ RETURN REWIND STOP SYNC_ALL SYNC_IMAGES SYNC_MEMORY UNLOCK WAIT WHERE WRITE INT_LITERAL_CONSTANT REAL_LITERAL_CONSTANT COMPLEX_LITERAL_CONSTANT LOGICAL_LITERAL_CONSTANT CHAR_LITERAL_CONSTANT BOZ_LITERAL_CONSTANT }
specification-part6_opt_autogen	{ END }
position-spec-list	{ ')' }
128_group_autogen	{ }
exit-stmt	{ FORMAT ENTRY DATA ALLOCATE NAME_LITERAL BACKSPACE CALL CLOSE CONTINUE CYCLE DEALLOCATE END ENDFILE ERROR_STOP EXIT FLUSH FORALL GO_TO IF INQUIRE LOCK NULLIFY OPEN PRINT READ RETURN REWIND STOP SYNC_ALL SYNC_IMAGES SYNC_MEMORY UNLOCK WAIT WHERE WRITE INT_LITERAL_CONSTANT REAL_LITERAL_CONSTANT COMPLEX_LITERAL_CONSTANT LOGICAL_LITERAL_CONSTANT CHAR_LITERAL_CONSTANT BOZ_LITERAL_CONSTANT }
module-subprogram-part	{ END }
','5_opt_autogen	{ NAME_LITERAL }
37_opt_autogen	{ '[' }
case-value-range	{ ')' }
bind-stmt	{ ENTRY FORMAT PARAMETER PROCEDURE 'TYPE' 'CLASS' NAME_LITERAL ENUM INTERFACE ABSTRACT_INTERFACE PUBLIC PRIVATE ALLOCATABLE ASYNCHRONOUS BIND CODIMENSION COMMON DATA DIMENSION EQUIVALENCE EXTERNAL INTENT INTRINSIC NAMELIST OPTIONAL POINTER PROTECTED SAVE TARGET VOLATILE VALUE INTEGER REAL DOUBLE_PRECISION COMPLEX CHARACTER LOGICAL }
198_group_autogen	{ }
defined-io-generic-spec	{ '=' ',' }
connect-spec-list	{ ')' }
data-pointer-object	{ '(' }
generic-spec2_opt_autogen	{ ENTRY FORMAT PARAMETER PROCEDURE 'TYPE' 'CLASS' NAME_LITERAL ENUM INTERFACE ABSTRACT_INTERFACE PUBLIC PRIVATE ALLOCATABLE ASYNCHRONOUS BIND CODIMENSION COMMON DATA DIMENSION EQUIVALENCE EXTERNAL INTENT INTRINSIC NAMELIST OPTIONAL POINTER PROTECTED SAVE TARGET VOLATILE VALUE INTEGER REAL DOUBLE_PRECISION COMPLEX CHARACTER LOGICAL }
designator	{ '%' '*' '=' ',' ')' }
io-implied-do-control	{ ')' }
private-or-sequence1_optlist_autogen	{ PRIVATE SEQUENCE }
NAME_LITERAL29_opt_autogen	{ }
data-i-do-object-list	{ ',' }
77_opt_autogen	{ NOT }
177_group_autogen	{ ',' }
92_opt_autogen	{ DO }
140_group_autogen	{ NAME_LITERAL }
19_opt_autogen	{ '*' ':' }
function-stmt	{ }
level-5-expr	{ EQV NEQV ')' ',' ':' '.' '=' '%' }
54_opt_autogen	{ NAME_LITERAL }
116_opt_autogen	{ '*' }
157_group_autogen	{ TYPE_IS CLASS_IS CLASS_DEFAULT END_SELECT }
bounds-remapping-list	{ ')' }
critical-construct	{ FORMAT ENTRY DATA ALLOCATE NAME_LITERAL BACKSPACE CALL CLOSE CONTINUE CYCLE DEALLOCATE END ENDFILE ERROR_STOP EXIT FLUSH FORALL GO_TO IF INQUIRE LOCK NULLIFY OPEN PRINT READ RETURN REWIND STOP SYNC_ALL SYNC_IMAGES SYNC_MEMORY UNLOCK WAIT WHERE WRITE INT_LITERAL_CONSTANT REAL_LITERAL_CONSTANT COMPLEX_LITERAL_CONSTANT LOGICAL_LITERAL_CONSTANT CHAR_LITERAL_CONSTANT BOZ_LITERAL_CONSTANT }
67_group_autogen	{ ',' }
allocate-coarray-spec	{ ']' }
lower-cobound	{ ':' }
138_opt_autogen	{ NAME_LITERAL }
91_opt_autogen	{ DO }
position-spec	{ ')' }
79_group_autogen	{ ',' }
dummy-arg-list2_opt_autogen	{ ')' }
7_group_autogen	{ }
cosubscript-list	{ ']' }
dtv-type-spec	{ }
108_opt_autogen	{ '*' NAME_LITERAL INT_LITERAL_CONSTANT REAL_LITERAL_CONSTANT COMPLEX_LITERAL_CONSTANT LOGICAL_LITERAL_CONSTANT CHAR_LITERAL_CONSTANT BOZ_LITERAL_CONSTANT }
10_group_autogen	{ }
32_group_autogen	{ NAME_LITERAL }
type-bound-procedure-part1_opt_autogen	{ END_TYPE }
60_group_autogen	{ '[' }
arithmetic-if-stmt	{ FORMAT ENTRY DATA ALLOCATE NAME_LITERAL BACKSPACE CALL CLOSE CONTINUE CYCLE DEALLOCATE END ENDFILE ERROR_STOP EXIT FLUSH FORALL GO_TO IF INQUIRE LOCK NULLIFY OPEN PRINT READ RETURN REWIND STOP SYNC_ALL SYNC_IMAGES SYNC_MEMORY UNLOCK WAIT WHERE WRITE INT_LITERAL_CONSTANT REAL_LITERAL_CONSTANT COMPLEX_LITERAL_CONSTANT LOGICAL_LITERAL_CONSTANT CHAR_LITERAL_CONSTANT BOZ_LITERAL_CONSTANT }
access-id	{ ',' NAME_LITERAL OPERATOR ASSIGNMENT READ WRITE }
proc-pointer-init	{ }
39_opt_autogen	{ NAME_LITERAL }
11_group_autogen	{ ',' }
118_opt_autogen	{ ',' ')' }
internal-subprogram-part4_opt_autogen	{ END }
type-param-decl	{ INTEGER }
225_group_autogen	{ ',' }
equivalence-set-list	{ ENTRY FORMAT PARAMETER PROCEDURE 'TYPE' 'CLASS' NAME_LITERAL ENUM INTERFACE ABSTRACT_INTERFACE PUBLIC PRIVATE ALLOCATABLE ASYNCHRONOUS BIND CODIMENSION COMMON DATA DIMENSION EQUIVALENCE EXTERNAL INTENT INTRINSIC NAMELIST OPTIONAL POINTER PROTECTED SAVE TARGET VOLATILE VALUE INTEGER REAL DOUBLE_PRECISION COMPLEX CHARACTER LOGICAL }
associate-stmt	{ }
r3_opt_autogen	{ '/' }
rel-op	{ }
46_optlist_autogen	{ ',' }
144_group_autogen	{ ASSOCIATE }
61_opt_autogen	{ '%' '*' }
NAME_LITERAL1_opt_autogen	{ ENTRY FORMAT PARAMETER PROCEDURE 'TYPE' 'CLASS' NAME_LITERAL ENUM INTERFACE ABSTRACT_INTERFACE PUBLIC PRIVATE ALLOCATABLE ASYNCHRONOUS BIND CODIMENSION COMMON DATA DIMENSION EQUIVALENCE EXTERNAL INTENT INTRINSIC NAMELIST OPTIONAL POINTER PROTECTED SAVE TARGET VOLATILE VALUE INTEGER REAL DOUBLE_PRECISION COMPLEX CHARACTER LOGICAL }
98_opt_autogen	{ NAME_LITERAL INT_LITERAL_CONSTANT REAL_LITERAL_CONSTANT COMPLEX_LITERAL_CONSTANT LOGICAL_LITERAL_CONSTANT CHAR_LITERAL_CONSTANT BOZ_LITERAL_CONSTANT }
41_optlist_autogen	{ ',' ENTRY FORMAT PARAMETER PROCEDURE 'TYPE' 'CLASS' NAME_LITERAL ENUM INTERFACE ABSTRACT_INTERFACE PUBLIC PRIVATE ALLOCATABLE ASYNCHRONOUS BIND CODIMENSION COMMON DATA DIMENSION EQUIVALENCE EXTERNAL INTENT INTRINSIC NAMELIST OPTIONAL POINTER PROTECTED SAVE TARGET VOLATILE VALUE INTEGER REAL DOUBLE_PRECISION COMPLEX CHARACTER LOGICAL }
specification-part9_opt_autogen	{ ALLOCATE NAME_LITERAL BACKSPACE CALL CLOSE CONTINUE CYCLE DEALLOCATE END ENDFILE ERROR_STOP EXIT FLUSH FORALL GO_TO IF INQUIRE LOCK NULLIFY OPEN PRINT READ RETURN REWIND STOP SYNC_ALL SYNC_IMAGES SYNC_MEMORY UNLOCK WAIT WHERE WRITE INT_LITERAL_CONSTANT REAL_LITERAL_CONSTANT COMPLEX_LITERAL_CONSTANT LOGICAL_LITERAL_CONSTANT CHAR_LITERAL_CONSTANT BOZ_LITERAL_CONSTANT }
44_opt_autogen	{ NAME_LITERAL '+' '-' INT_LITERAL_CONSTANT REAL_LITERAL_CONSTANT COMPLEX_LITERAL_CONSTANT LOGICAL_LITERAL_CONSTANT CHAR_LITERAL_CONSTANT BOZ_LITERAL_CONSTANT }
component-initialization1_opt_autogen	{ }
82_opt_autogen	{ END_WHERE }
allocate-stmt	{ FORMAT ENTRY DATA ALLOCATE NAME_LITERAL BACKSPACE CALL CLOSE CONTINUE CYCLE DEALLOCATE END ENDFILE ERROR_STOP EXIT FLUSH FORALL GO_TO IF INQUIRE LOCK NULLIFY OPEN PRINT READ RETURN REWIND STOP SYNC_ALL SYNC_IMAGES SYNC_MEMORY UNLOCK WAIT WHERE WRITE INT_LITERAL_CONSTANT REAL_LITERAL_CONSTANT COMPLEX_LITERAL_CONSTANT LOGICAL_LITERAL_CONSTANT CHAR_LITERAL_CONSTANT BOZ_LITERAL_CONSTANT }
51_opt_autogen	{ NAME_LITERAL }
close-spec-list	{ ')' }
8_opt_autogen	{ ':' NAME_LITERAL }
declaration-construct1_optlist_autogen	{ ENTRY FORMAT PARAMETER PROCEDURE 'TYPE' 'CLASS' NAME_LITERAL ENUM INTERFACE ABSTRACT_INTERFACE PUBLIC PRIVATE ALLOCATABLE ASYNCHRONOUS BIND CODIMENSION COMMON DATA DIMENSION EQUIVALENCE EXTERNAL INTENT INTRINSIC NAMELIST OPTIONAL POINTER PROTECTED SAVE TARGET VOLATILE VALUE INTEGER REAL DOUBLE_PRECISION COMPLEX CHARACTER LOGICAL }
83_opt_autogen	{ WHERE }
parent-identifier	{ ')' }
176_group_autogen	{ ',' }
165_group_autogen	{ ',' }
component-initialization	{ }
66_group_autogen	{ NAME_LITERAL }
NAME_LITERAL3_opt_autogen	{ '/' }
position-edit-desc	{ ',' ')' }
associate-construct	{ FORMAT ENTRY DATA ALLOCATE NAME_LITERAL BACKSPACE CALL CLOSE CONTINUE CYCLE DEALLOCATE END ENDFILE ERROR_STOP EXIT FLUSH FORALL GO_TO IF INQUIRE LOCK NULLIFY OPEN PRINT READ RETURN REWIND STOP SYNC_ALL SYNC_IMAGES SYNC_MEMORY UNLOCK WAIT WHERE WRITE INT_LITERAL_CONSTANT REAL_LITERAL_CONSTANT COMPLEX_LITERAL_CONSTANT LOGICAL_LITERAL_CONSTANT CHAR_LITERAL_CONSTANT BOZ_LITERAL_CONSTANT }
62_opt_autogen	{ }
97_group_autogen	{ ',' }
read-stmt	{ FORMAT ENTRY DATA ALLOCATE NAME_LITERAL BACKSPACE CALL CLOSE CONTINUE CYCLE DEALLOCATE END ENDFILE ERROR_STOP EXIT FLUSH FORALL GO_TO IF INQUIRE LOCK NULLIFY OPEN PRINT READ RETURN REWIND STOP SYNC_ALL SYNC_IMAGES SYNC_MEMORY UNLOCK WAIT WHERE WRITE INT_LITERAL_CONSTANT REAL_LITERAL_CONSTANT COMPLEX_LITERAL_CONSTANT LOGICAL_LITERAL_CONSTANT CHAR_LITERAL_CONSTANT BOZ_LITERAL_CONSTANT }
56_opt_autogen	{ }
71_optlist_autogen	{ ',' ')' }
49_optlist_autogen	{ ',' }
kind-selector	{ ',' }
29_group_autogen	{ ',' }
internal-subprogram-part1_opt_autogen	{ END }
73_opt_autogen	{ '.' }
NAME_LITERAL26_opt_autogen	{ }
attr-spec	{ NAME_LITERAL }
ac-value-list	{ ',' '/' ']' }
forall-assignment-stmt	{ WHERE NAME_LITERAL FORALL INT_LITERAL_CONSTANT REAL_LITERAL_CONSTANT COMPLEX_LITERAL_CONSTANT LOGICAL_LITERAL_CONSTANT CHAR_LITERAL_CONSTANT BOZ_LITERAL_CONSTANT END_FORALL FORMAT ENTRY DATA ALLOCATE BACKSPACE CALL CLOSE CONTINUE CYCLE DEALLOCATE END ENDFILE ERROR_STOP EXIT FLUSH GO_TO IF INQUIRE LOCK NULLIFY OPEN PRINT READ RETURN REWIND STOP SYNC_ALL SYNC_IMAGES SYNC_MEMORY UNLOCK WAIT WRITE }
30_group_autogen	{ NAME_LITERAL INT_LITERAL_CONSTANT REAL_LITERAL_CONSTANT COMPLEX_LITERAL_CONSTANT LOGICAL_LITERAL_CONSTANT CHAR_LITERAL_CONSTANT BOZ_LITERAL_CONSTANT }
component-attr-spec	{ }
27_optlist_autogen	{ ',' FORMAT ENTRY DATA ALLOCATE NAME_LITERAL BACKSPACE CALL CLOSE CONTINUE CYCLE DEALLOCATE END ENDFILE ERROR_STOP EXIT FLUSH FORALL GO_TO IF INQUIRE LOCK NULLIFY OPEN PRINT READ RETURN REWIND STOP SYNC_ALL SYNC_IMAGES SYNC_MEMORY UNLOCK WAIT WHERE WRITE INT_LITERAL_CONSTANT REAL_LITERAL_CONSTANT COMPLEX_LITERAL_CONSTANT LOGICAL_LITERAL_CONSTANT CHAR_LITERAL_CONSTANT BOZ_LITERAL_CONSTANT PARAMETER PROCEDURE 'TYPE' 'CLASS' ENUM INTERFACE ABSTRACT_INTERFACE PUBLIC PRIVATE ALLOCATABLE ASYNCHRONOUS BIND CODIMENSION COMMON DIMENSION EQUIVALENCE EXTERNAL INTENT INTRINSIC NAMELIST OPTIONAL POINTER PROTECTED SAVE TARGET VOLATILE VALUE INTEGER REAL DOUBLE_PRECISION COMPLEX CHARACTER LOGICAL }
proc-decl	{ 'TYPE' 'CLASS' PROCEDURE INTEGER REAL DOUBLE_PRECISION COMPLEX CHARACTER LOGICAL ENTRY FORMAT PARAMETER NAME_LITERAL ENUM INTERFACE ABSTRACT_INTERFACE PUBLIC PRIVATE ALLOCATABLE ASYNCHRONOUS BIND CODIMENSION COMMON DATA DIMENSION EQUIVALENCE EXTERNAL INTENT INTRINSIC NAMELIST OPTIONAL POINTER PROTECTED SAVE TARGET VOLATILE VALUE }
enumerator	{ ENUMERATOR END_ENUM }
internal-subprogram1_optlist_autogen	{ 'TYPE' 'CLASS' ELEMENTAL IMPURE MODULE PURE RECURSIVE INTEGER REAL DOUBLE_PRECISION COMPLEX CHARACTER LOGICAL }
other-specification-stmt	{ ENTRY FORMAT PARAMETER PROCEDURE 'TYPE' 'CLASS' NAME_LITERAL ENUM INTERFACE ABSTRACT_INTERFACE PUBLIC PRIVATE ALLOCATABLE ASYNCHRONOUS BIND CODIMENSION COMMON DATA DIMENSION EQUIVALENCE EXTERNAL INTENT INTRINSIC NAMELIST OPTIONAL POINTER PROTECTED SAVE TARGET VOLATILE VALUE INTEGER REAL DOUBLE_PRECISION COMPLEX CHARACTER LOGICAL }
2_optlist_autogen	{ ',' ')' }
format-specification	{ IMPLICIT IMPLICIT_NONE PARAMETER FORMAT ENTRY PROCEDURE 'TYPE' 'CLASS' NAME_LITERAL ENUM INTERFACE ABSTRACT_INTERFACE PUBLIC PRIVATE ALLOCATABLE ASYNCHRONOUS BIND CODIMENSION COMMON DATA DIMENSION EQUIVALENCE EXTERNAL INTENT INTRINSIC NAMELIST OPTIONAL POINTER PROTECTED SAVE TARGET VOLATILE VALUE INTEGER REAL DOUBLE_PRECISION COMPLEX CHARACTER LOGICAL ALLOCATE BACKSPACE CALL CLOSE CONTINUE CYCLE DEALLOCATE END ENDFILE ERROR_STOP EXIT FLUSH FORALL GO_TO IF INQUIRE LOCK NULLIFY OPEN PRINT READ RETURN REWIND STOP SYNC_ALL SYNC_IMAGES SYNC_MEMORY UNLOCK WAIT WHERE WRITE INT_LITERAL_CONSTANT REAL_LITERAL_CONSTANT COMPLEX_LITERAL_CONSTANT LOGICAL_LITERAL_CONSTANT CHAR_LITERAL_CONSTANT BOZ_LITERAL_CONSTANT }
implicit-spec	{ IMPLICIT IMPLICIT_NONE PARAMETER FORMAT ENTRY }
proc-interface	{ ')' }
73_group_autogen	{ NAME_LITERAL '+' '-' INT_LITERAL_CONSTANT REAL_LITERAL_CONSTANT COMPLEX_LITERAL_CONSTANT LOGICAL_LITERAL_CONSTANT CHAR_LITERAL_CONSTANT BOZ_LITERAL_CONSTANT }
subscript	{ ':' }
pointer-stmt	{ ENTRY FORMAT PARAMETER PROCEDURE 'TYPE' 'CLASS' NAME_LITERAL ENUM INTERFACE ABSTRACT_INTERFACE PUBLIC PRIVATE ALLOCATABLE ASYNCHRONOUS BIND CODIMENSION COMMON DATA DIMENSION EQUIVALENCE EXTERNAL INTENT INTRINSIC NAMELIST OPTIONAL POINTER PROTECTED SAVE TARGET VOLATILE VALUE INTEGER REAL DOUBLE_PRECISION COMPLEX CHARACTER LOGICAL }
43_group_autogen	{ ',' }
use-stmt1_optlist_autogen	{ USE }
71_group_autogen	{ ')' }
130_group_autogen	{ }
internal-subprogram-part2_opt_autogen	{ END }
actual-arg	{ }
175_group_autogen	{ NAME_LITERAL }
90_group_autogen	{ NAME_LITERAL }
35_opt_autogen	{ NAME_LITERAL OPERATOR ASSIGNMENT READ WRITE ENTRY FORMAT PARAMETER PROCEDURE 'TYPE' 'CLASS' ENUM INTERFACE ABSTRACT_INTERFACE PUBLIC PRIVATE ALLOCATABLE ASYNCHRONOUS BIND CODIMENSION COMMON DATA DIMENSION EQUIVALENCE EXTERNAL INTENT INTRINSIC NAMELIST OPTIONAL POINTER PROTECTED SAVE TARGET VOLATILE VALUE INTEGER REAL DOUBLE_PRECISION COMPLEX CHARACTER LOGICAL }
continue-stmt	{ FORMAT ENTRY DATA ALLOCATE NAME_LITERAL BACKSPACE CALL CLOSE CONTINUE CYCLE DEALLOCATE END ENDFILE ERROR_STOP EXIT FLUSH FORALL GO_TO IF INQUIRE LOCK NULLIFY OPEN PRINT READ RETURN REWIND STOP SYNC_ALL SYNC_IMAGES SYNC_MEMORY UNLOCK WAIT WHERE WRITE INT_LITERAL_CONSTANT REAL_LITERAL_CONSTANT COMPLEX_LITERAL_CONSTANT LOGICAL_LITERAL_CONSTANT CHAR_LITERAL_CONSTANT BOZ_LITERAL_CONSTANT }
backspace-stmt	{ FORMAT ENTRY DATA ALLOCATE NAME_LITERAL BACKSPACE CALL CLOSE CONTINUE CYCLE DEALLOCATE END ENDFILE ERROR_STOP EXIT FLUSH FORALL GO_TO IF INQUIRE LOCK NULLIFY OPEN PRINT READ RETURN REWIND STOP SYNC_ALL SYNC_IMAGES SYNC_MEMORY UNLOCK WAIT WHERE WRITE INT_LITERAL_CONSTANT REAL_LITERAL_CONSTANT COMPLEX_LITERAL_CONSTANT LOGICAL_LITERAL_CONSTANT CHAR_LITERAL_CONSTANT BOZ_LITERAL_CONSTANT }
19_optlist_autogen	{ ',' ')' }
','9_opt_autogen	{ INT_LITERAL_CONSTANT ':' CHAR_LITERAL_CONSTANT 'T' 'TL' 'TR' 'SS' 'SP' 'S' 'BN' 'BZ' 'RU' 'RD' 'RZ' 'RN' 'RC' 'RP' 'DC' 'DP' '+' '-' }
118_group_autogen	{ '*' }
only-list1_opt_autogen	{ USE }
where-stmt	{ FORMAT ENTRY DATA ALLOCATE NAME_LITERAL BACKSPACE CALL CLOSE CONTINUE CYCLE DEALLOCATE END ENDFILE ERROR_STOP EXIT FLUSH FORALL GO_TO IF INQUIRE LOCK NULLIFY OPEN PRINT READ RETURN REWIND STOP SYNC_ALL SYNC_IMAGES SYNC_MEMORY UNLOCK WAIT WHERE WRITE INT_LITERAL_CONSTANT REAL_LITERAL_CONSTANT COMPLEX_LITERAL_CONSTANT LOGICAL_LITERAL_CONSTANT CHAR_LITERAL_CONSTANT BOZ_LITERAL_CONSTANT END_FORALL }
vector-subscript	{ }
component-decl	{ 'TYPE' 'CLASS' PROCEDURE INTEGER REAL DOUBLE_PRECISION COMPLEX CHARACTER LOGICAL }
executable-construct	{ FORMAT ENTRY DATA ALLOCATE NAME_LITERAL BACKSPACE CALL CLOSE CONTINUE CYCLE DEALLOCATE END ENDFILE ERROR_STOP EXIT FLUSH FORALL GO_TO IF INQUIRE LOCK NULLIFY OPEN PRINT READ RETURN REWIND STOP SYNC_ALL SYNC_IMAGES SYNC_MEMORY UNLOCK WAIT WHERE WRITE INT_LITERAL_CONSTANT REAL_LITERAL_CONSTANT COMPLEX_LITERAL_CONSTANT LOGICAL_LITERAL_CONSTANT CHAR_LITERAL_CONSTANT BOZ_LITERAL_CONSTANT }
38_optlist_autogen	{ ',' ENTRY FORMAT PARAMETER PROCEDURE 'TYPE' 'CLASS' NAME_LITERAL ENUM INTERFACE ABSTRACT_INTERFACE PUBLIC PRIVATE ALLOCATABLE ASYNCHRONOUS BIND CODIMENSION COMMON DATA DIMENSION EQUIVALENCE EXTERNAL INTENT INTRINSIC NAMELIST OPTIONAL POINTER PROTECTED SAVE TARGET VOLATILE VALUE INTEGER REAL DOUBLE_PRECISION COMPLEX CHARACTER LOGICAL }
51_optlist_autogen	{ ',' }
signed-real-literal-constant	{ }
prefix1_opt_autogen	{ FUNCTION }
59_optlist_autogen	{ ',' ')' }
15_optlist_autogen	{ ',' ENTRY FORMAT PARAMETER PROCEDURE 'TYPE' 'CLASS' NAME_LITERAL ENUM INTERFACE ABSTRACT_INTERFACE PUBLIC PRIVATE ALLOCATABLE ASYNCHRONOUS BIND CODIMENSION COMMON DATA DIMENSION EQUIVALENCE EXTERNAL INTENT INTRINSIC NAMELIST OPTIONAL POINTER PROTECTED SAVE TARGET VOLATILE VALUE INTEGER REAL DOUBLE_PRECISION COMPLEX CHARACTER LOGICAL }
46_group_autogen	{ }
specification-part7_opt_autogen	{ END }
forall-construct-stmt	{ }
initial-data-target	{ }
146_group_autogen	{ BLOCK }
output-item-list1_opt_autogen	{ FORMAT ENTRY DATA ALLOCATE NAME_LITERAL BACKSPACE CALL CLOSE CONTINUE CYCLE DEALLOCATE END ENDFILE ERROR_STOP EXIT FLUSH FORALL GO_TO IF INQUIRE LOCK NULLIFY OPEN PRINT READ RETURN REWIND STOP SYNC_ALL SYNC_IMAGES SYNC_MEMORY UNLOCK WAIT WHERE WRITE INT_LITERAL_CONSTANT REAL_LITERAL_CONSTANT COMPLEX_LITERAL_CONSTANT LOGICAL_LITERAL_CONSTANT CHAR_LITERAL_CONSTANT BOZ_LITERAL_CONSTANT }
NAME_LITERAL6_opt_autogen	{ FORMAT ENTRY DATA ALLOCATE NAME_LITERAL BACKSPACE CALL CLOSE CONTINUE CYCLE DEALLOCATE END ENDFILE ERROR_STOP EXIT FLUSH FORALL GO_TO IF INQUIRE LOCK NULLIFY OPEN PRINT READ RETURN REWIND STOP SYNC_ALL SYNC_IMAGES SYNC_MEMORY UNLOCK WAIT WHERE WRITE INT_LITERAL_CONSTANT REAL_LITERAL_CONSTANT COMPLEX_LITERAL_CONSTANT LOGICAL_LITERAL_CONSTANT CHAR_LITERAL_CONSTANT BOZ_LITERAL_CONSTANT }
assumed-size-spec-list	{ }
83_group_autogen	{ NAME_LITERAL }
121_group_autogen	{ ',' }
dummy-arg-list	{ ')' }
23_optlist_autogen	{ ',' ')' }
common-stmt	{ ENTRY FORMAT PARAMETER PROCEDURE 'TYPE' 'CLASS' NAME_LITERAL ENUM INTERFACE ABSTRACT_INTERFACE PUBLIC PRIVATE ALLOCATABLE ASYNCHRONOUS BIND CODIMENSION COMMON DATA DIMENSION EQUIVALENCE EXTERNAL INTENT INTRINSIC NAMELIST OPTIONAL POINTER PROTECTED SAVE TARGET VOLATILE VALUE INTEGER REAL DOUBLE_PRECISION COMPLEX CHARACTER LOGICAL }
224_group_autogen	{ }
31_opt_autogen	{ '*' }
actual-arg-spec-list2_opt_autogen	{ ')' }
23_group_autogen	{ ':' }
input-item-list	{ }
35_optlist_autogen	{ ',' ENTRY FORMAT PARAMETER PROCEDURE 'TYPE' 'CLASS' NAME_LITERAL ENUM INTERFACE ABSTRACT_INTERFACE PUBLIC PRIVATE ALLOCATABLE ASYNCHRONOUS BIND CODIMENSION COMMON DATA DIMENSION EQUIVALENCE EXTERNAL INTENT INTRINSIC NAMELIST OPTIONAL POINTER PROTECTED SAVE TARGET VOLATILE VALUE INTEGER REAL DOUBLE_PRECISION COMPLEX CHARACTER LOGICAL }
71_opt_autogen	{ ')' }
16_group_autogen	{ '=' }
80_optlist_autogen	{ ',' ')' }
69_group_autogen	{ ',' }
52_optlist_autogen	{ ',' ')' }
61_group_autogen	{ }
144_opt_autogen	{ FORMAT ENTRY DATA ALLOCATE NAME_LITERAL BACKSPACE CALL CLOSE CONTINUE CYCLE DEALLOCATE END ENDFILE ERROR_STOP EXIT FLUSH FORALL GO_TO IF INQUIRE LOCK NULLIFY OPEN PRINT READ RETURN REWIND STOP SYNC_ALL SYNC_IMAGES SYNC_MEMORY UNLOCK WAIT WHERE WRITE INT_LITERAL_CONSTANT REAL_LITERAL_CONSTANT COMPLEX_LITERAL_CONSTANT LOGICAL_LITERAL_CONSTANT CHAR_LITERAL_CONSTANT BOZ_LITERAL_CONSTANT MODULE 'TYPE' 'CLASS' ELEMENTAL IMPURE PURE RECURSIVE INTEGER REAL DOUBLE_PRECISION COMPLEX CHARACTER LOGICAL END_INTERFACE PROGRAM SUBMODULE BLOCK_DATA MODULE_PROCEDURE }
117_opt_autogen	{ ',' ')' }
129_group_autogen	{ NOT }
7_optlist_autogen	{ ',' ':' }
data-stmt-value	{ '/' }
178_group_autogen	{ ',' }
not-op1_opt_autogen	{ }
24_opt_autogen	{ ')' }
subroutine-subprogram	{ PROGRAM MODULE SUBMODULE BLOCK_DATA 'TYPE' 'CLASS' ELEMENTAL IMPURE PURE RECURSIVE INTEGER REAL DOUBLE_PRECISION COMPLEX CHARACTER LOGICAL MODULE_PROCEDURE }
103_group_autogen	{ '[' }
stop-stmt	{ FORMAT ENTRY DATA ALLOCATE NAME_LITERAL BACKSPACE CALL CLOSE CONTINUE CYCLE DEALLOCATE END ENDFILE ERROR_STOP EXIT FLUSH FORALL GO_TO IF INQUIRE LOCK NULLIFY OPEN PRINT READ RETURN REWIND STOP SYNC_ALL SYNC_IMAGES SYNC_MEMORY UNLOCK WAIT WHERE WRITE INT_LITERAL_CONSTANT REAL_LITERAL_CONSTANT COMPLEX_LITERAL_CONSTANT LOGICAL_LITERAL_CONSTANT CHAR_LITERAL_CONSTANT BOZ_LITERAL_CONSTANT }
target-decl	{ ENTRY FORMAT PARAMETER PROCEDURE 'TYPE' 'CLASS' NAME_LITERAL ENUM INTERFACE ABSTRACT_INTERFACE PUBLIC PRIVATE ALLOCATABLE ASYNCHRONOUS BIND CODIMENSION COMMON DATA DIMENSION EQUIVALENCE EXTERNAL INTENT INTRINSIC NAMELIST OPTIONAL POINTER PROTECTED SAVE TARGET VOLATILE VALUE INTEGER REAL DOUBLE_PRECISION COMPLEX CHARACTER LOGICAL }
type-attr-spec-list	{ }
length-selector	{ }
sync-stat-list	{ ')' }
45_optlist_autogen	{ ',' }
169_group_autogen	{ }
defined-op1_opt_autogen	{ NAME_LITERAL '(' '[' INT_LITERAL_CONSTANT REAL_LITERAL_CONSTANT COMPLEX_LITERAL_CONSTANT LOGICAL_LITERAL_CONSTANT CHAR_LITERAL_CONSTANT BOZ_LITERAL_CONSTANT }
component-spec-list1_opt_autogen	{ ')' }
5_opt_autogen	{ ':' NAME_LITERAL }
114_group_autogen	{ ',' }
45_group_autogen	{ ',' }
output-item	{ }
66_opt_autogen	{ }
23_opt_autogen	{ '(' }
19_group_autogen	{ ',' }
module-stmt	{ }
wait-spec-list	{ ')' }
end-block-data-stmt	{ PROGRAM MODULE SUBMODULE BLOCK_DATA 'TYPE' 'CLASS' ELEMENTAL IMPURE PURE RECURSIVE INTEGER REAL DOUBLE_PRECISION COMPLEX CHARACTER LOGICAL }
189_group_autogen	{ '*' }
wait-spec	{ ')' }
NAME_LITERAL30_opt_autogen	{ }
120_opt_autogen	{ ',' ')' }
114_opt_autogen	{ }
alloc-opt-list	{ }
49_group_autogen	{ ',' }
defined-operator	{ ')' }
NAME_LITERAL24_opt_autogen	{ }
184_group_autogen	{ ',' }
182_group_autogen	{ ',' }
206_group_autogen	{ ',' }
1_opt_autogen	{ }
procedure-declaration-stmt	{ ENTRY FORMAT PARAMETER PROCEDURE 'TYPE' 'CLASS' NAME_LITERAL ENUM INTERFACE ABSTRACT_INTERFACE PUBLIC PRIVATE ALLOCATABLE ASYNCHRONOUS BIND CODIMENSION COMMON DATA DIMENSION EQUIVALENCE EXTERNAL INTENT INTRINSIC NAMELIST OPTIONAL POINTER PROTECTED SAVE TARGET VOLATILE VALUE INTEGER REAL DOUBLE_PRECISION COMPLEX CHARACTER LOGICAL }
main-program	{ PROGRAM MODULE SUBMODULE BLOCK_DATA 'TYPE' 'CLASS' ELEMENTAL IMPURE PURE RECURSIVE INTEGER REAL DOUBLE_PRECISION COMPLEX CHARACTER LOGICAL }
end-forall-stmt	{ FORMAT ENTRY DATA ALLOCATE NAME_LITERAL BACKSPACE CALL CLOSE CONTINUE CYCLE DEALLOCATE END ENDFILE ERROR_STOP EXIT FLUSH FORALL GO_TO IF INQUIRE LOCK NULLIFY OPEN PRINT READ RETURN REWIND STOP SYNC_ALL SYNC_IMAGES SYNC_MEMORY UNLOCK WAIT WHERE WRITE INT_LITERAL_CONSTANT REAL_LITERAL_CONSTANT COMPLEX_LITERAL_CONSTANT LOGICAL_LITERAL_CONSTANT CHAR_LITERAL_CONSTANT BOZ_LITERAL_CONSTANT }
implicit-spec-list	{ IMPLICIT IMPLICIT_NONE PARAMETER FORMAT ENTRY }
close-stmt	{ FORMAT ENTRY DATA ALLOCATE NAME_LITERAL BACKSPACE CALL CLOSE CONTINUE CYCLE DEALLOCATE END ENDFILE ERROR_STOP EXIT FLUSH FORALL GO_TO IF INQUIRE LOCK NULLIFY OPEN PRINT READ RETURN REWIND STOP SYNC_ALL SYNC_IMAGES SYNC_MEMORY UNLOCK WAIT WHERE WRITE INT_LITERAL_CONSTANT REAL_LITERAL_CONSTANT COMPLEX_LITERAL_CONSTANT LOGICAL_LITERAL_CONSTANT CHAR_LITERAL_CONSTANT BOZ_LITERAL_CONSTANT }
allocate-coshape-spec-list	{ ',' }
109_group_autogen	{ ')' }
declaration-construct	{ ENTRY FORMAT PARAMETER PROCEDURE 'TYPE' 'CLASS' NAME_LITERAL ENUM INTERFACE ABSTRACT_INTERFACE PUBLIC PRIVATE ALLOCATABLE ASYNCHRONOUS BIND CODIMENSION COMMON DATA DIMENSION EQUIVALENCE EXTERNAL INTENT INTRINSIC NAMELIST OPTIONAL POINTER PROTECTED SAVE TARGET VOLATILE VALUE INTEGER REAL DOUBLE_PRECISION COMPLEX CHARACTER LOGICAL }
94_opt_autogen	{ END_IF }
external-stmt	{ ENTRY FORMAT PARAMETER PROCEDURE 'TYPE' 'CLASS' NAME_LITERAL ENUM INTERFACE ABSTRACT_INTERFACE PUBLIC PRIVATE ALLOCATABLE ASYNCHRONOUS BIND CODIMENSION COMMON DATA DIMENSION EQUIVALENCE EXTERNAL INTENT INTRINSIC NAMELIST OPTIONAL POINTER PROTECTED SAVE TARGET VOLATILE VALUE INTEGER REAL DOUBLE_PRECISION COMPLEX CHARACTER LOGICAL }
36_opt_autogen	{ NAME_LITERAL OPERATOR ASSIGNMENT READ WRITE }
common-block-object-list	{ ENTRY FORMAT PARAMETER PROCEDURE 'TYPE' 'CLASS' NAME_LITERAL ENUM INTERFACE ABSTRACT_INTERFACE PUBLIC PRIVATE ALLOCATABLE ASYNCHRONOUS BIND CODIMENSION COMMON DATA DIMENSION EQUIVALENCE EXTERNAL INTENT INTRINSIC NAMELIST OPTIONAL POINTER PROTECTED SAVE TARGET VOLATILE VALUE INTEGER REAL DOUBLE_PRECISION COMPLEX CHARACTER LOGICAL }
and-op	{ }
deferred-coshape-spec	{ ']' }
equivalence-object-list	{ ')' }
21_group_autogen	{ }
prefix	{ FUNCTION SUBROUTINE }
73_optlist_autogen	{ ',' ')' }
111_opt_autogen	{ ')' }
forall-body-construct1_optlist_autogen	{ WHERE NAME_LITERAL FORALL INT_LITERAL_CONSTANT REAL_LITERAL_CONSTANT COMPLEX_LITERAL_CONSTANT LOGICAL_LITERAL_CONSTANT CHAR_LITERAL_CONSTANT BOZ_LITERAL_CONSTANT END_FORALL }
component-spec-list	{ ')' }
block-stmt	{ }
192_group_autogen	{ }
stop-code1_opt_autogen	{ FORMAT ENTRY DATA ALLOCATE NAME_LITERAL BACKSPACE CALL CLOSE CONTINUE CYCLE DEALLOCATE END ENDFILE ERROR_STOP EXIT FLUSH FORALL GO_TO IF INQUIRE LOCK NULLIFY OPEN PRINT READ RETURN REWIND STOP SYNC_ALL SYNC_IMAGES SYNC_MEMORY UNLOCK WAIT WHERE WRITE INT_LITERAL_CONSTANT REAL_LITERAL_CONSTANT COMPLEX_LITERAL_CONSTANT LOGICAL_LITERAL_CONSTANT CHAR_LITERAL_CONSTANT BOZ_LITERAL_CONSTANT }
NAME_LITERAL23_opt_autogen	{ }
access-stmt	{ ENTRY FORMAT PARAMETER PROCEDURE 'TYPE' 'CLASS' NAME_LITERAL ENUM INTERFACE ABSTRACT_INTERFACE PUBLIC PRIVATE ALLOCATABLE ASYNCHRONOUS BIND CODIMENSION COMMON DATA DIMENSION EQUIVALENCE EXTERNAL INTENT INTRINSIC NAMELIST OPTIONAL POINTER PROTECTED SAVE TARGET VOLATILE VALUE INTEGER REAL DOUBLE_PRECISION COMPLEX CHARACTER LOGICAL }
initialization	{ }
level-2-expr	{ '+' '-' '/' EQ NE LT LE GT GE '=' '<' '>' }
135_opt_autogen	{ NAME_LITERAL }
rename	{ }
21_optlist_autogen	{ }
bind-entity-list	{ ENTRY FORMAT PARAMETER PROCEDURE 'TYPE' 'CLASS' NAME_LITERAL ENUM INTERFACE ABSTRACT_INTERFACE PUBLIC PRIVATE ALLOCATABLE ASYNCHRONOUS BIND CODIMENSION COMMON DATA DIMENSION EQUIVALENCE EXTERNAL INTENT INTRINSIC NAMELIST OPTIONAL POINTER PROTECTED SAVE TARGET VOLATILE VALUE INTEGER REAL DOUBLE_PRECISION COMPLEX CHARACTER LOGICAL }
211_group_autogen	{ NAME_LITERAL }
equivalence-stmt	{ ENTRY FORMAT PARAMETER PROCEDURE 'TYPE' 'CLASS' NAME_LITERAL ENUM INTERFACE ABSTRACT_INTERFACE PUBLIC PRIVATE ALLOCATABLE ASYNCHRONOUS BIND CODIMENSION COMMON DATA DIMENSION EQUIVALENCE EXTERNAL INTENT INTRINSIC NAMELIST OPTIONAL POINTER PROTECTED SAVE TARGET VOLATILE VALUE INTEGER REAL DOUBLE_PRECISION COMPLEX CHARACTER LOGICAL }
kind-selector2_opt_autogen	{ ')' ':' ',' '(' }
24_group_autogen	{ }
initial-proc-target	{ }
saved-entity	{ NAME_LITERAL '/' }
only-list	{ }
131_opt_autogen	{ ')' }
145_group_autogen	{ ',' }
end-select-stmt	{ FORMAT ENTRY DATA ALLOCATE NAME_LITERAL BACKSPACE CALL CLOSE CONTINUE CYCLE DEALLOCATE END ENDFILE ERROR_STOP EXIT FLUSH FORALL GO_TO IF INQUIRE LOCK NULLIFY OPEN PRINT READ RETURN REWIND STOP SYNC_ALL SYNC_IMAGES SYNC_MEMORY UNLOCK WAIT WHERE WRITE INT_LITERAL_CONSTANT REAL_LITERAL_CONSTANT COMPLEX_LITERAL_CONSTANT LOGICAL_LITERAL_CONSTANT CHAR_LITERAL_CONSTANT BOZ_LITERAL_CONSTANT }
218_group_autogen	{ NAME_LITERAL }
contiguous-stmt	{ }
unlock-stmt	{ FORMAT ENTRY DATA ALLOCATE NAME_LITERAL BACKSPACE CALL CLOSE CONTINUE CYCLE DEALLOCATE END ENDFILE ERROR_STOP EXIT FLUSH FORALL GO_TO IF INQUIRE LOCK NULLIFY OPEN PRINT READ RETURN REWIND STOP SYNC_ALL SYNC_IMAGES SYNC_MEMORY UNLOCK WAIT WHERE WRITE INT_LITERAL_CONSTANT REAL_LITERAL_CONSTANT COMPLEX_LITERAL_CONSTANT LOGICAL_LITERAL_CONSTANT CHAR_LITERAL_CONSTANT BOZ_LITERAL_CONSTANT }
112_opt_autogen	{ }
array-spec	{ ')' }
10_opt_autogen	{ '*' }
93_group_autogen	{ }
143_opt_autogen	{ }
76_optlist_autogen	{ ',' }
entry-stmt	{ IMPLICIT IMPLICIT_NONE PARAMETER FORMAT ENTRY PROCEDURE 'TYPE' 'CLASS' NAME_LITERAL ENUM INTERFACE ABSTRACT_INTERFACE PUBLIC PRIVATE ALLOCATABLE ASYNCHRONOUS BIND CODIMENSION COMMON DATA DIMENSION EQUIVALENCE EXTERNAL INTENT INTRINSIC NAMELIST OPTIONAL POINTER PROTECTED SAVE TARGET VOLATILE VALUE INTEGER REAL DOUBLE_PRECISION COMPLEX CHARACTER LOGICAL ALLOCATE BACKSPACE CALL CLOSE CONTINUE CYCLE DEALLOCATE END ENDFILE ERROR_STOP EXIT FLUSH FORALL GO_TO IF INQUIRE LOCK NULLIFY OPEN PRINT READ RETURN REWIND STOP SYNC_ALL SYNC_IMAGES SYNC_MEMORY UNLOCK WAIT WHERE WRITE INT_LITERAL_CONSTANT REAL_LITERAL_CONSTANT COMPLEX_LITERAL_CONSTANT LOGICAL_LITERAL_CONSTANT CHAR_LITERAL_CONSTANT BOZ_LITERAL_CONSTANT }
substring-range	{ ')' }
case-value-range-list	{ ')' }
and-operand	{ AND }
name-list1_opt_autogen	{ ')' }
loop-control	{ }
217_group_autogen	{ ',' }
program-unit	{ PROGRAM MODULE SUBMODULE BLOCK_DATA 'TYPE' 'CLASS' ELEMENTAL IMPURE PURE RECURSIVE INTEGER REAL DOUBLE_PRECISION COMPLEX CHARACTER LOGICAL }
9_group_autogen	{ ',' }
explicit-coshape-spec	{ ']' }
128_opt_autogen	{ ':' NAME_LITERAL }
41_group_autogen	{ '=' }
implicit-part-stmt1_optlist_autogen	{ IMPLICIT IMPLICIT_NONE PARAMETER FORMAT ENTRY }
mult-op	{ }
193_group_autogen	{ }
sign2_opt_autogen	{ REAL_LITERAL_CONSTANT }
47_group_autogen	{ '*' }
assumed-size-spec	{ ')' }
11_opt_autogen	{ '=' }
module-nature	{ }
134_group_autogen	{ ',' }
159_group_autogen	{ NAME_LITERAL INT_LITERAL_CONSTANT REAL_LITERAL_CONSTANT COMPLEX_LITERAL_CONSTANT LOGICAL_LITERAL_CONSTANT CHAR_LITERAL_CONSTANT BOZ_LITERAL_CONSTANT }
stop-code2_opt_autogen	{ FORMAT ENTRY DATA ALLOCATE NAME_LITERAL BACKSPACE CALL CLOSE CONTINUE CYCLE DEALLOCATE END ENDFILE ERROR_STOP EXIT FLUSH FORALL GO_TO IF INQUIRE LOCK NULLIFY OPEN PRINT READ RETURN REWIND STOP SYNC_ALL SYNC_IMAGES SYNC_MEMORY UNLOCK WAIT WHERE WRITE INT_LITERAL_CONSTANT REAL_LITERAL_CONSTANT COMPLEX_LITERAL_CONSTANT LOGICAL_LITERAL_CONSTANT CHAR_LITERAL_CONSTANT BOZ_LITERAL_CONSTANT }
sufix2_opt_autogen	{ }
88_opt_autogen	{ ASSOCIATE }
end-enum-stmt	{ ENTRY FORMAT PARAMETER PROCEDURE 'TYPE' 'CLASS' NAME_LITERAL ENUM INTERFACE ABSTRACT_INTERFACE PUBLIC PRIVATE ALLOCATABLE ASYNCHRONOUS BIND CODIMENSION COMMON DATA DIMENSION EQUIVALENCE EXTERNAL INTENT INTRINSIC NAMELIST OPTIONAL POINTER PROTECTED SAVE TARGET VOLATILE VALUE INTEGER REAL DOUBLE_PRECISION COMPLEX CHARACTER LOGICAL }
constant	{ '*' '(' }
38_opt_autogen	{ }
65_opt_autogen	{ '[' }
program-stmt	{ }
28_optlist_autogen	{ ',' '/' }
expr1_opt_autogen	{ ':' }
generic-spec	{ '=' ',' }
format-items	{ ',' ')' }
47_opt_autogen	{ NAME_LITERAL }
226_group_autogen	{ }
deferred-shape-spec	{ ')' }
explicit-shape-spec-list	{ ')' }
where-body-construct	{ WHERE NAME_LITERAL INT_LITERAL_CONSTANT REAL_LITERAL_CONSTANT COMPLEX_LITERAL_CONSTANT LOGICAL_LITERAL_CONSTANT CHAR_LITERAL_CONSTANT BOZ_LITERAL_CONSTANT }
133_group_autogen	{ '=' }
namelist-stmt	{ ENTRY FORMAT PARAMETER PROCEDURE 'TYPE' 'CLASS' NAME_LITERAL ENUM INTERFACE ABSTRACT_INTERFACE PUBLIC PRIVATE ALLOCATABLE ASYNCHRONOUS BIND CODIMENSION COMMON DATA DIMENSION EQUIVALENCE EXTERNAL INTENT INTRINSIC NAMELIST OPTIONAL POINTER PROTECTED SAVE TARGET VOLATILE VALUE INTEGER REAL DOUBLE_PRECISION COMPLEX CHARACTER LOGICAL }
203_group_autogen	{ ':' NAME_LITERAL }
inquire-spec-list	{ ')' }
intrinsic-type-spec	{ ')' ':' ',' '(' }
mult-operand	{ '*' '/' }
separate-module-subprogram	{ MODULE_PROCEDURE 'TYPE' 'CLASS' ELEMENTAL IMPURE MODULE PURE RECURSIVE INTEGER REAL DOUBLE_PRECISION COMPLEX CHARACTER LOGICAL }
40_optlist_autogen	{ ',' ')' }
w	{ '.' 'E' ',' ')' }
40_opt_autogen	{ NAME_LITERAL '/' }
NAME_LITERAL7_opt_autogen	{ FORMAT ENTRY DATA ALLOCATE NAME_LITERAL BACKSPACE CALL CLOSE CONTINUE CYCLE DEALLOCATE END ENDFILE ERROR_STOP EXIT FLUSH FORALL GO_TO IF INQUIRE LOCK NULLIFY OPEN PRINT READ RETURN REWIND STOP SYNC_ALL SYNC_IMAGES SYNC_MEMORY UNLOCK WAIT WHERE WRITE INT_LITERAL_CONSTANT REAL_LITERAL_CONSTANT COMPLEX_LITERAL_CONSTANT LOGICAL_LITERAL_CONSTANT CHAR_LITERAL_CONSTANT BOZ_LITERAL_CONSTANT }
NAME_LITERAL4_opt_autogen	{ }
nonlabel-do-stmt	{ }
io-implied-do	{ }
association	{ ')' }
asynchronous-stmt	{ ENTRY FORMAT PARAMETER PROCEDURE 'TYPE' 'CLASS' NAME_LITERAL ENUM INTERFACE ABSTRACT_INTERFACE PUBLIC PRIVATE ALLOCATABLE ASYNCHRONOUS BIND CODIMENSION COMMON DATA DIMENSION EQUIVALENCE EXTERNAL INTENT INTRINSIC NAMELIST OPTIONAL POINTER PROTECTED SAVE TARGET VOLATILE VALUE INTEGER REAL DOUBLE_PRECISION COMPLEX CHARACTER LOGICAL }
where-body-construct2_optlist_autogen	{ WHERE NAME_LITERAL INT_LITERAL_CONSTANT REAL_LITERAL_CONSTANT COMPLEX_LITERAL_CONSTANT LOGICAL_LITERAL_CONSTANT CHAR_LITERAL_CONSTANT BOZ_LITERAL_CONSTANT }
NAME_LITERAL16_opt_autogen	{ }
array-element	{ ',' '%' '*' '(' }
type-bound-proc-decl	{ PROCEDURE GENERIC FINAL }
210_group_autogen	{ }
6_opt_autogen	{ }
saved-entity-list	{ NAME_LITERAL '/' }
blank-interp-edit-desc	{ ',' ')' }
89_opt_autogen	{ BLOCK }
target-stmt	{ ENTRY FORMAT PARAMETER PROCEDURE 'TYPE' 'CLASS' NAME_LITERAL ENUM INTERFACE ABSTRACT_INTERFACE PUBLIC PRIVATE ALLOCATABLE ASYNCHRONOUS BIND CODIMENSION COMMON DATA DIMENSION EQUIVALENCE EXTERNAL INTENT INTRINSIC NAMELIST OPTIONAL POINTER PROTECTED SAVE TARGET VOLATILE VALUE INTEGER REAL DOUBLE_PRECISION COMPLEX CHARACTER LOGICAL }
module-subprogram-part2_opt_autogen	{ END }
138_group_autogen	{ WHERE }
','7_opt_autogen	{ CONCURRENT }
level-3-expr	{ '/' EQ NE LT LE GT GE '=' '<' '>' }
e	{ }
4_optlist_autogen	{ ',' INTEGER }
allocate-coshape-spec	{ ',' }
component-part1_opt_autogen	{ CONTAINS }
146_opt_autogen	{ IMPLICIT IMPLICIT_NONE PARAMETER FORMAT ENTRY PROCEDURE 'TYPE' 'CLASS' NAME_LITERAL ENUM INTERFACE ABSTRACT_INTERFACE PUBLIC PRIVATE ALLOCATABLE ASYNCHRONOUS BIND CODIMENSION COMMON DATA DIMENSION EQUIVALENCE EXTERNAL INTENT INTRINSIC NAMELIST OPTIONAL POINTER PROTECTED SAVE TARGET VOLATILE VALUE INTEGER REAL DOUBLE_PRECISION COMPLEX CHARACTER LOGICAL ALLOCATE BACKSPACE CALL CLOSE CONTINUE CYCLE DEALLOCATE END ENDFILE ERROR_STOP EXIT FLUSH FORALL GO_TO IF INQUIRE LOCK NULLIFY OPEN PRINT READ RETURN REWIND STOP SYNC_ALL SYNC_IMAGES SYNC_MEMORY UNLOCK WAIT WHERE WRITE INT_LITERAL_CONSTANT REAL_LITERAL_CONSTANT COMPLEX_LITERAL_CONSTANT LOGICAL_LITERAL_CONSTANT CHAR_LITERAL_CONSTANT BOZ_LITERAL_CONSTANT }
99_opt_autogen	{ FORMAT ENTRY DATA ALLOCATE NAME_LITERAL BACKSPACE CALL CLOSE CONTINUE CYCLE DEALLOCATE END ENDFILE ERROR_STOP EXIT FLUSH FORALL GO_TO IF INQUIRE LOCK NULLIFY OPEN PRINT READ RETURN REWIND STOP SYNC_ALL SYNC_IMAGES SYNC_MEMORY UNLOCK WAIT WHERE WRITE INT_LITERAL_CONSTANT REAL_LITERAL_CONSTANT COMPLEX_LITERAL_CONSTANT LOGICAL_LITERAL_CONSTANT CHAR_LITERAL_CONSTANT BOZ_LITERAL_CONSTANT }
access-spec	{ ':' NAME_LITERAL ENTRY FORMAT PARAMETER PROCEDURE 'TYPE' 'CLASS' ENUM INTERFACE ABSTRACT_INTERFACE PUBLIC PRIVATE ALLOCATABLE ASYNCHRONOUS BIND CODIMENSION COMMON DATA DIMENSION EQUIVALENCE EXTERNAL INTENT INTRINSIC NAMELIST OPTIONAL POINTER PROTECTED SAVE TARGET VOLATILE VALUE INTEGER REAL DOUBLE_PRECISION COMPLEX CHARACTER LOGICAL }
write-stmt	{ FORMAT ENTRY DATA ALLOCATE NAME_LITERAL BACKSPACE CALL CLOSE CONTINUE CYCLE DEALLOCATE END ENDFILE ERROR_STOP EXIT FLUSH FORALL GO_TO IF INQUIRE LOCK NULLIFY OPEN PRINT READ RETURN REWIND STOP SYNC_ALL SYNC_IMAGES SYNC_MEMORY UNLOCK WAIT WHERE WRITE INT_LITERAL_CONSTANT REAL_LITERAL_CONSTANT COMPLEX_LITERAL_CONSTANT LOGICAL_LITERAL_CONSTANT CHAR_LITERAL_CONSTANT BOZ_LITERAL_CONSTANT }
proc-component-def-stmt	{ 'TYPE' 'CLASS' PROCEDURE INTEGER REAL DOUBLE_PRECISION COMPLEX CHARACTER LOGICAL }
data-stmt-value-list	{ '/' }
io-control-spec-list	{ ')' }
sync-stat-list1_opt_autogen	{ ')' }
data-target	{ FORMAT ENTRY DATA ALLOCATE NAME_LITERAL BACKSPACE CALL CLOSE CONTINUE CYCLE DEALLOCATE END ENDFILE ERROR_STOP EXIT FLUSH FORALL GO_TO IF INQUIRE LOCK NULLIFY OPEN PRINT READ RETURN REWIND STOP SYNC_ALL SYNC_IMAGES SYNC_MEMORY UNLOCK WAIT WHERE WRITE INT_LITERAL_CONSTANT REAL_LITERAL_CONSTANT COMPLEX_LITERAL_CONSTANT LOGICAL_LITERAL_CONSTANT CHAR_LITERAL_CONSTANT BOZ_LITERAL_CONSTANT }
33_group_autogen	{ }
50_optlist_autogen	{ ',' ')' }
79_opt_autogen	{ }
72_opt_autogen	{ }
50_opt_autogen	{ NAME_LITERAL '/' ENTRY FORMAT PARAMETER PROCEDURE 'TYPE' 'CLASS' ENUM INTERFACE ABSTRACT_INTERFACE PUBLIC PRIVATE ALLOCATABLE ASYNCHRONOUS BIND CODIMENSION COMMON DATA DIMENSION EQUIVALENCE EXTERNAL INTENT INTRINSIC NAMELIST OPTIONAL POINTER PROTECTED SAVE TARGET VOLATILE VALUE INTEGER REAL DOUBLE_PRECISION COMPLEX CHARACTER LOGICAL }
import-stmt	{ IMPORT }
95_opt_autogen	{ IF }
where-construct-stmt	{ }
40_group_autogen	{ '*' }
91_group_autogen	{ NAME_LITERAL }
49_opt_autogen	{ NAME_LITERAL }
84_opt_autogen	{ FORALL }
','4_opt_autogen	{ '/' }
56_optlist_autogen	{ ',' ')' }
inquire-spec	{ ')' }
11_optlist_autogen	{ ',' ')' }
expr2_opt_autogen	{ ')' }
76_opt_autogen	{ }
endfile-stmt	{ FORMAT ENTRY DATA ALLOCATE NAME_LITERAL BACKSPACE CALL CLOSE CONTINUE CYCLE DEALLOCATE END ENDFILE ERROR_STOP EXIT FLUSH FORALL GO_TO IF INQUIRE LOCK NULLIFY OPEN PRINT READ RETURN REWIND STOP SYNC_ALL SYNC_IMAGES SYNC_MEMORY UNLOCK WAIT WHERE WRITE INT_LITERAL_CONSTANT REAL_LITERAL_CONSTANT COMPLEX_LITERAL_CONSTANT LOGICAL_LITERAL_CONSTANT CHAR_LITERAL_CONSTANT BOZ_LITERAL_CONSTANT }
explicit-shape-spec	{ ',' ')' }
rename-list	{ }
else-if-stmt	{ }
sufix	{ }
50_group_autogen	{ ',' }
46_opt_autogen	{ NAME_LITERAL }
implicit-part1_opt_autogen	{ }
execution-part	{ CONTAINS }
initialization1_opt_autogen	{ }
137_opt_autogen	{ }
critical-stmt	{ }
55_group_autogen	{ '*' }
216_group_autogen	{ }
74_optlist_autogen	{ ',' ')' }
unlimited-format-item	{ ')' }
null-init	{ }
char-literal-constant	{ '(' ',' ')' }
end-do-stmt	{ FORMAT ENTRY DATA ALLOCATE NAME_LITERAL BACKSPACE CALL CLOSE CONTINUE CYCLE DEALLOCATE END ENDFILE ERROR_STOP EXIT FLUSH FORALL GO_TO IF INQUIRE LOCK NULLIFY OPEN PRINT READ RETURN REWIND STOP SYNC_ALL SYNC_IMAGES SYNC_MEMORY UNLOCK WAIT WHERE WRITE INT_LITERAL_CONSTANT REAL_LITERAL_CONSTANT COMPLEX_LITERAL_CONSTANT LOGICAL_LITERAL_CONSTANT CHAR_LITERAL_CONSTANT BOZ_LITERAL_CONSTANT }
85_group_autogen	{ ',' }
end-interface-stmt	{ ENTRY FORMAT PARAMETER PROCEDURE 'TYPE' 'CLASS' NAME_LITERAL ENUM INTERFACE ABSTRACT_INTERFACE PUBLIC PRIVATE ALLOCATABLE ASYNCHRONOUS BIND CODIMENSION COMMON DATA DIMENSION EQUIVALENCE EXTERNAL INTENT INTRINSIC NAMELIST OPTIONAL POINTER PROTECTED SAVE TARGET VOLATILE VALUE INTEGER REAL DOUBLE_PRECISION COMPLEX CHARACTER LOGICAL }
inner-shared-do-construct	{ FORMAT ENTRY DATA ALLOCATE NAME_LITERAL BACKSPACE CALL CLOSE CONTINUE CYCLE DEALLOCATE END ENDFILE ERROR_STOP EXIT FLUSH FORALL GO_TO IF INQUIRE LOCK NULLIFY OPEN PRINT READ RETURN REWIND STOP SYNC_ALL SYNC_IMAGES SYNC_MEMORY UNLOCK WAIT WHERE WRITE INT_LITERAL_CONSTANT REAL_LITERAL_CONSTANT COMPLEX_LITERAL_CONSTANT LOGICAL_LITERAL_CONSTANT CHAR_LITERAL_CONSTANT BOZ_LITERAL_CONSTANT }
55_opt_autogen	{ NAME_LITERAL }
interface-body	{ MODULE 'TYPE' 'CLASS' ELEMENTAL IMPURE PURE RECURSIVE INTEGER REAL DOUBLE_PRECISION COMPLEX CHARACTER LOGICAL END_INTERFACE }
130_opt_autogen	{ ':' NAME_LITERAL }
nullify-stmt	{ FORMAT ENTRY DATA ALLOCATE NAME_LITERAL BACKSPACE CALL CLOSE CONTINUE CYCLE DEALLOCATE END ENDFILE ERROR_STOP EXIT FLUSH FORALL GO_TO IF INQUIRE LOCK NULLIFY OPEN PRINT READ RETURN REWIND STOP SYNC_ALL SYNC_IMAGES SYNC_MEMORY UNLOCK WAIT WHERE WRITE INT_LITERAL_CONSTANT REAL_LITERAL_CONSTANT COMPLEX_LITERAL_CONSTANT LOGICAL_LITERAL_CONSTANT CHAR_LITERAL_CONSTANT BOZ_LITERAL_CONSTANT }
name-list	{ ')' PROCEDURE GENERIC FINAL ENTRY FORMAT PARAMETER 'TYPE' 'CLASS' NAME_LITERAL ENUM INTERFACE ABSTRACT_INTERFACE PUBLIC PRIVATE ALLOCATABLE ASYNCHRONOUS BIND CODIMENSION COMMON DATA DIMENSION EQUIVALENCE EXTERNAL INTENT INTRINSIC NAMELIST OPTIONAL POINTER PROTECTED SAVE TARGET VOLATILE VALUE INTEGER REAL DOUBLE_PRECISION COMPLEX CHARACTER LOGICAL MODULE ELEMENTAL IMPURE PURE RECURSIVE END_INTERFACE IMPORT }
forall-header	{ NAME_LITERAL INT_LITERAL_CONSTANT REAL_LITERAL_CONSTANT COMPLEX_LITERAL_CONSTANT LOGICAL_LITERAL_CONSTANT CHAR_LITERAL_CONSTANT BOZ_LITERAL_CONSTANT }
component-def-stmt	{ 'TYPE' 'CLASS' PROCEDURE INTEGER REAL DOUBLE_PRECISION COMPLEX CHARACTER LOGICAL }
3_opt_autogen	{ ')' }
label-list	{ ')' }
78_optlist_autogen	{ ',' 'TYPE' 'CLASS' PROCEDURE INTEGER REAL DOUBLE_PRECISION COMPLEX CHARACTER LOGICAL ENTRY FORMAT PARAMETER NAME_LITERAL ENUM INTERFACE ABSTRACT_INTERFACE PUBLIC PRIVATE ALLOCATABLE ASYNCHRONOUS BIND CODIMENSION COMMON DATA DIMENSION EQUIVALENCE EXTERNAL INTENT INTRINSIC NAMELIST OPTIONAL POINTER PROTECTED SAVE TARGET VOLATILE VALUE }
87_opt_autogen	{ }
43_opt_autogen	{ ')' }
186_group_autogen	{ ',' }
55_optlist_autogen	{ ',' }
202_group_autogen	{ }
where-body-construct3_optlist_autogen	{ WHERE NAME_LITERAL INT_LITERAL_CONSTANT REAL_LITERAL_CONSTANT COMPLEX_LITERAL_CONSTANT LOGICAL_LITERAL_CONSTANT CHAR_LITERAL_CONSTANT BOZ_LITERAL_CONSTANT }
interface-specification1_optlist_autogen	{ MODULE 'TYPE' 'CLASS' ELEMENTAL IMPURE PURE RECURSIVE INTEGER REAL DOUBLE_PRECISION COMPLEX CHARACTER LOGICAL END_INTERFACE }
197_group_autogen	{ }
25_opt_autogen	{ '[' }
69_optlist_autogen	{ ',' ')' }
64_opt_autogen	{ ')' }
v	{ ')' }
round-edit-desc	{ ',' ')' }
lower-bound	{ ':' }
boz-literal-constant	{ }
94_group_autogen	{ ',' }
79_optlist_autogen	{ ',' ')' }
101_group_autogen	{ ',' }
implicit-stmt	{ IMPLICIT IMPLICIT_NONE PARAMETER FORMAT ENTRY }
type-bound-proc-binding	{ PROCEDURE GENERIC FINAL }
34_optlist_autogen	{ ',' NAME_LITERAL '/' }
ac-implied-do-control	{ ')' }
signed-int-literal-constant	{ 'P' }
35_group_autogen	{ '(' }
24_optlist_autogen	{ ',' ENTRY FORMAT PARAMETER PROCEDURE 'TYPE' 'CLASS' NAME_LITERAL ENUM INTERFACE ABSTRACT_INTERFACE PUBLIC PRIVATE ALLOCATABLE ASYNCHRONOUS BIND CODIMENSION COMMON DATA DIMENSION EQUIVALENCE EXTERNAL INTENT INTRINSIC NAMELIST OPTIONAL POINTER PROTECTED SAVE TARGET VOLATILE VALUE INTEGER REAL DOUBLE_PRECISION COMPLEX CHARACTER LOGICAL }
d	{ 'E' '.' ',' ')' }
optional-stmt	{ ENTRY FORMAT PARAMETER PROCEDURE 'TYPE' 'CLASS' NAME_LITERAL ENUM INTERFACE ABSTRACT_INTERFACE PUBLIC PRIVATE ALLOCATABLE ASYNCHRONOUS BIND CODIMENSION COMMON DATA DIMENSION EQUIVALENCE EXTERNAL INTENT INTRINSIC NAMELIST OPTIONAL POINTER PROTECTED SAVE TARGET VOLATILE VALUE INTEGER REAL DOUBLE_PRECISION COMPLEX CHARACTER LOGICAL }
27_opt_autogen	{ '=' }
18_optlist_autogen	{ ',' ')' }
36_optlist_autogen	{ ',' IMPLICIT IMPLICIT_NONE PARAMETER FORMAT ENTRY }
131_group_autogen	{ }
142_group_autogen	{ }
58_group_autogen	{ }
59_group_autogen	{ NAME_LITERAL }
33_opt_autogen	{ '*' }
41_opt_autogen	{ NAME_LITERAL }
allocatable-decl-list	{ ENTRY FORMAT PARAMETER PROCEDURE 'TYPE' 'CLASS' NAME_LITERAL ENUM INTERFACE ABSTRACT_INTERFACE PUBLIC PRIVATE ALLOCATABLE ASYNCHRONOUS BIND CODIMENSION COMMON DATA DIMENSION EQUIVALENCE EXTERNAL INTENT INTRINSIC NAMELIST OPTIONAL POINTER PROTECTED SAVE TARGET VOLATILE VALUE INTEGER REAL DOUBLE_PRECISION COMPLEX CHARACTER LOGICAL }
stop-code	{ }
81_opt_autogen	{ '=' }
io-implied-do-object-list	{ ',' }
execution-part-construct	{ FORMAT ENTRY DATA ALLOCATE NAME_LITERAL BACKSPACE CALL CLOSE CONTINUE CYCLE DEALLOCATE END ENDFILE ERROR_STOP EXIT FLUSH FORALL GO_TO IF INQUIRE LOCK NULLIFY OPEN PRINT READ RETURN REWIND STOP SYNC_ALL SYNC_IMAGES SYNC_MEMORY UNLOCK WAIT WHERE WRITE INT_LITERAL_CONSTANT REAL_LITERAL_CONSTANT COMPLEX_LITERAL_CONSTANT LOGICAL_LITERAL_CONSTANT CHAR_LITERAL_CONSTANT BOZ_LITERAL_CONSTANT }
program	{ _FINISH_ }
end-do	{ FORMAT ENTRY DATA ALLOCATE NAME_LITERAL BACKSPACE CALL CLOSE CONTINUE CYCLE DEALLOCATE END ENDFILE ERROR_STOP EXIT FLUSH FORALL GO_TO IF INQUIRE LOCK NULLIFY OPEN PRINT READ RETURN REWIND STOP SYNC_ALL SYNC_IMAGES SYNC_MEMORY UNLOCK WAIT WHERE WRITE INT_LITERAL_CONSTANT REAL_LITERAL_CONSTANT COMPLEX_LITERAL_CONSTANT LOGICAL_LITERAL_CONSTANT CHAR_LITERAL_CONSTANT BOZ_LITERAL_CONSTANT }
implicit-part-stmt	{ IMPLICIT IMPLICIT_NONE PARAMETER FORMAT ENTRY }
125_opt_autogen	{ ',' ')' }
private-components-stmt	{ PRIVATE SEQUENCE }
80_group_autogen	{ NAME_LITERAL }
outer-shared-do-construct	{ FORMAT ENTRY DATA ALLOCATE NAME_LITERAL BACKSPACE CALL CLOSE CONTINUE CYCLE DEALLOCATE END ENDFILE ERROR_STOP EXIT FLUSH FORALL GO_TO IF INQUIRE LOCK NULLIFY OPEN PRINT READ RETURN REWIND STOP SYNC_ALL SYNC_IMAGES SYNC_MEMORY UNLOCK WAIT WHERE WRITE INT_LITERAL_CONSTANT REAL_LITERAL_CONSTANT COMPLEX_LITERAL_CONSTANT LOGICAL_LITERAL_CONSTANT CHAR_LITERAL_CONSTANT BOZ_LITERAL_CONSTANT }
4_group_autogen	{ ')' }
type-bound-procedure-stmt	{ PROCEDURE GENERIC FINAL }
private-or-sequence	{ PRIVATE SEQUENCE }
module-subprogram1_optlist_autogen	{ MODULE_PROCEDURE 'TYPE' 'CLASS' ELEMENTAL IMPURE MODULE PURE RECURSIVE INTEGER REAL DOUBLE_PRECISION COMPLEX CHARACTER LOGICAL END }
type-bound-procedure-part	{ END_TYPE }
equivalence-set	{ ENTRY FORMAT PARAMETER PROCEDURE 'TYPE' 'CLASS' NAME_LITERAL ENUM INTERFACE ABSTRACT_INTERFACE PUBLIC PRIVATE ALLOCATABLE ASYNCHRONOUS BIND CODIMENSION COMMON DATA DIMENSION EQUIVALENCE EXTERNAL INTENT INTRINSIC NAMELIST OPTIONAL POINTER PROTECTED SAVE TARGET VOLATILE VALUE INTEGER REAL DOUBLE_PRECISION COMPLEX CHARACTER LOGICAL }
case-stmt	{ }
forall-stmt	{ FORMAT ENTRY DATA ALLOCATE NAME_LITERAL BACKSPACE CALL CLOSE CONTINUE CYCLE DEALLOCATE END ENDFILE ERROR_STOP EXIT FLUSH FORALL GO_TO IF INQUIRE LOCK NULLIFY OPEN PRINT READ RETURN REWIND STOP SYNC_ALL SYNC_IMAGES SYNC_MEMORY UNLOCK WAIT WHERE WRITE INT_LITERAL_CONSTANT REAL_LITERAL_CONSTANT COMPLEX_LITERAL_CONSTANT LOGICAL_LITERAL_CONSTANT CHAR_LITERAL_CONSTANT BOZ_LITERAL_CONSTANT END_FORALL }
125_group_autogen	{ '.' }
NAME_LITERAL17_opt_autogen	{ FORMAT ENTRY DATA ALLOCATE NAME_LITERAL BACKSPACE CALL CLOSE CONTINUE CYCLE DEALLOCATE END ENDFILE ERROR_STOP EXIT FLUSH FORALL GO_TO IF INQUIRE LOCK NULLIFY OPEN PRINT READ RETURN REWIND STOP SYNC_ALL SYNC_IMAGES SYNC_MEMORY UNLOCK WAIT WHERE WRITE INT_LITERAL_CONSTANT REAL_LITERAL_CONSTANT COMPLEX_LITERAL_CONSTANT LOGICAL_LITERAL_CONSTANT CHAR_LITERAL_CONSTANT BOZ_LITERAL_CONSTANT }
call-stmt	{ FORMAT ENTRY DATA ALLOCATE NAME_LITERAL BACKSPACE CALL CLOSE CONTINUE CYCLE DEALLOCATE END ENDFILE ERROR_STOP EXIT FLUSH FORALL GO_TO IF INQUIRE LOCK NULLIFY OPEN PRINT READ RETURN REWIND STOP SYNC_ALL SYNC_IMAGES SYNC_MEMORY UNLOCK WAIT WHERE WRITE INT_LITERAL_CONSTANT REAL_LITERAL_CONSTANT COMPLEX_LITERAL_CONSTANT LOGICAL_LITERAL_CONSTANT CHAR_LITERAL_CONSTANT BOZ_LITERAL_CONSTANT }
format-items1_opt_autogen	{ ')' }
value-stmt	{ ENTRY FORMAT PARAMETER PROCEDURE 'TYPE' 'CLASS' NAME_LITERAL ENUM INTERFACE ABSTRACT_INTERFACE PUBLIC PRIVATE ALLOCATABLE ASYNCHRONOUS BIND CODIMENSION COMMON DATA DIMENSION EQUIVALENCE EXTERNAL INTENT INTRINSIC NAMELIST OPTIONAL POINTER PROTECTED SAVE TARGET VOLATILE VALUE INTEGER REAL DOUBLE_PRECISION COMPLEX CHARACTER LOGICAL }
internal-subprogram-part3_opt_autogen	{ END }
48_group_autogen	{ }
39_optlist_autogen	{ ',' ENTRY FORMAT PARAMETER PROCEDURE 'TYPE' 'CLASS' NAME_LITERAL ENUM INTERFACE ABSTRACT_INTERFACE PUBLIC PRIVATE ALLOCATABLE ASYNCHRONOUS BIND CODIMENSION COMMON DATA DIMENSION EQUIVALENCE EXTERNAL INTENT INTRINSIC NAMELIST OPTIONAL POINTER PROTECTED SAVE TARGET VOLATILE VALUE INTEGER REAL DOUBLE_PRECISION COMPLEX CHARACTER LOGICAL }
170_group_autogen	{ ',' }
93_opt_autogen	{ }
kind-selector3_opt_autogen	{ ')' ':' ',' '(' }
167_group_autogen	{ }
binding-attr-list	{ ':' }
execution-part3_opt_autogen	{ CONTAINS }
NAME_LITERAL25_opt_autogen	{ }
136_opt_autogen	{ NAME_LITERAL }
m	{ }
42_opt_autogen	{ NAME_LITERAL }
45_opt_autogen	{ NAME_LITERAL }
prefix-spec1_list_autogen	{ 'TYPE' 'CLASS' ELEMENTAL IMPURE MODULE PURE RECURSIVE INTEGER REAL DOUBLE_PRECISION COMPLEX CHARACTER LOGICAL }
100_opt_autogen	{ ')' }
68_opt_autogen	{ }
kind-selector4_opt_autogen	{ ')' ':' ',' '(' }
case-construct	{ FORMAT ENTRY DATA ALLOCATE NAME_LITERAL BACKSPACE CALL CLOSE CONTINUE CYCLE DEALLOCATE END ENDFILE ERROR_STOP EXIT FLUSH FORALL GO_TO IF INQUIRE LOCK NULLIFY OPEN PRINT READ RETURN REWIND STOP SYNC_ALL SYNC_IMAGES SYNC_MEMORY UNLOCK WAIT WHERE WRITE INT_LITERAL_CONSTANT REAL_LITERAL_CONSTANT COMPLEX_LITERAL_CONSTANT LOGICAL_LITERAL_CONSTANT CHAR_LITERAL_CONSTANT BOZ_LITERAL_CONSTANT }
34_opt_autogen	{ '*' }
format-item	{ ',' ')' }
procedure-designator	{ '(' FORMAT ENTRY DATA ALLOCATE NAME_LITERAL BACKSPACE CALL CLOSE CONTINUE CYCLE DEALLOCATE END ENDFILE ERROR_STOP EXIT FLUSH FORALL GO_TO IF INQUIRE LOCK NULLIFY OPEN PRINT READ RETURN REWIND STOP SYNC_ALL SYNC_IMAGES SYNC_MEMORY UNLOCK WAIT WHERE WRITE INT_LITERAL_CONSTANT REAL_LITERAL_CONSTANT COMPLEX_LITERAL_CONSTANT LOGICAL_LITERAL_CONSTANT CHAR_LITERAL_CONSTANT BOZ_LITERAL_CONSTANT }
sync-stat-list2_opt_autogen	{ ')' }
type-param-inquiry	{ }
63_opt_autogen	{ NAME_LITERAL }
6_group_autogen	{ ':' NAME_LITERAL }
add-operand	{ '*' '/' '+' '-' }
196_group_autogen	{ }
3_optlist_autogen	{ ',' }
alt-return-spec	{ }
file-unit-number	{ FORMAT ENTRY DATA ALLOCATE NAME_LITERAL BACKSPACE CALL CLOSE CONTINUE CYCLE DEALLOCATE END ENDFILE ERROR_STOP EXIT FLUSH FORALL GO_TO IF INQUIRE LOCK NULLIFY OPEN PRINT READ RETURN REWIND STOP SYNC_ALL SYNC_IMAGES SYNC_MEMORY UNLOCK WAIT WHERE WRITE INT_LITERAL_CONSTANT REAL_LITERAL_CONSTANT COMPLEX_LITERAL_CONSTANT LOGICAL_LITERAL_CONSTANT CHAR_LITERAL_CONSTANT BOZ_LITERAL_CONSTANT }
pointer-decl-list	{ ENTRY FORMAT PARAMETER PROCEDURE 'TYPE' 'CLASS' NAME_LITERAL ENUM INTERFACE ABSTRACT_INTERFACE PUBLIC PRIVATE ALLOCATABLE ASYNCHRONOUS BIND CODIMENSION COMMON DATA DIMENSION EQUIVALENCE EXTERNAL INTENT INTRINSIC NAMELIST OPTIONAL POINTER PROTECTED SAVE TARGET VOLATILE VALUE INTEGER REAL DOUBLE_PRECISION COMPLEX CHARACTER LOGICAL }
data-component-def-stmt	{ 'TYPE' 'CLASS' PROCEDURE INTEGER REAL DOUBLE_PRECISION COMPLEX CHARACTER LOGICAL }
kind-selector5_opt_autogen	{ ',' }
ac-spec	{ '/' ']' }
end-subroutine-stmt	{ FORMAT ENTRY DATA ALLOCATE NAME_LITERAL BACKSPACE CALL CLOSE CONTINUE CYCLE DEALLOCATE END ENDFILE ERROR_STOP EXIT FLUSH FORALL GO_TO IF INQUIRE LOCK NULLIFY OPEN PRINT READ RETURN REWIND STOP SYNC_ALL SYNC_IMAGES SYNC_MEMORY UNLOCK WAIT WHERE WRITE INT_LITERAL_CONSTANT REAL_LITERAL_CONSTANT COMPLEX_LITERAL_CONSTANT LOGICAL_LITERAL_CONSTANT CHAR_LITERAL_CONSTANT BOZ_LITERAL_CONSTANT MODULE 'TYPE' 'CLASS' ELEMENTAL IMPURE PURE RECURSIVE INTEGER REAL DOUBLE_PRECISION COMPLEX CHARACTER LOGICAL END_INTERFACE PROGRAM SUBMODULE BLOCK_DATA MODULE_PROCEDURE }
47_optlist_autogen	{ ',' }
binding-private-stmt1_opt_autogen	{ END_TYPE }
188_group_autogen	{ ',' }
88_group_autogen	{ }
30_opt_autogen	{ }
60_opt_autogen	{ '[' '%' '(' }
proc-interface2_opt_autogen	{ ')' }
14_opt_autogen	{ }
literal-constant	{ }
io-control-spec	{ ')' }
forall-limit	{ ':' }
72_optlist_autogen	{ ',' ')' }
defined-op	{ ')' NAME_LITERAL '(' '[' INT_LITERAL_CONSTANT REAL_LITERAL_CONSTANT COMPLEX_LITERAL_CONSTANT LOGICAL_LITERAL_CONSTANT CHAR_LITERAL_CONSTANT BOZ_LITERAL_CONSTANT }
163_group_autogen	{ }
54_optlist_autogen	{ ELSEWHERE }
124_group_autogen	{ }
126_opt_autogen	{ FORMAT ENTRY DATA ALLOCATE NAME_LITERAL BACKSPACE CALL CLOSE CONTINUE CYCLE DEALLOCATE END ENDFILE ERROR_STOP EXIT FLUSH FORALL GO_TO IF INQUIRE LOCK NULLIFY OPEN PRINT READ RETURN REWIND STOP SYNC_ALL SYNC_IMAGES SYNC_MEMORY UNLOCK WAIT WHERE WRITE INT_LITERAL_CONSTANT REAL_LITERAL_CONSTANT COMPLEX_LITERAL_CONSTANT LOGICAL_LITERAL_CONSTANT CHAR_LITERAL_CONSTANT BOZ_LITERAL_CONSTANT PROGRAM MODULE SUBMODULE BLOCK_DATA 'TYPE' 'CLASS' ELEMENTAL IMPURE PURE RECURSIVE INTEGER REAL DOUBLE_PRECISION COMPLEX CHARACTER LOGICAL }
implied-shape-spec	{ ')' }
86_opt_autogen	{ ')' }
entity-decl-list	{ ENTRY FORMAT PARAMETER PROCEDURE 'TYPE' 'CLASS' NAME_LITERAL ENUM INTERFACE ABSTRACT_INTERFACE PUBLIC PRIVATE ALLOCATABLE ASYNCHRONOUS BIND CODIMENSION COMMON DATA DIMENSION EQUIVALENCE EXTERNAL INTENT INTRINSIC NAMELIST OPTIONAL POINTER PROTECTED SAVE TARGET VOLATILE VALUE INTEGER REAL DOUBLE_PRECISION COMPLEX CHARACTER LOGICAL }
191_group_autogen	{ }
image-selector	{ }
194_group_autogen	{ }
type-param-spec	{ ')' }
data-edit-desc	{ ',' ')' }
70_opt_autogen	{ }
119_opt_autogen	{ ',' ')' }
200_group_autogen	{ ',' }
32_optlist_autogen	{ ',' ')' }
allocation-list	{ ',' }
1_optlist_autogen	{ ',' ')' }
67_opt_autogen	{ }
section-subscript-list	{ ')' }
do-body	{ ALLOCATE NAME_LITERAL BACKSPACE CALL CLOSE CONTINUE CYCLE DEALLOCATE END ENDFILE ERROR_STOP EXIT FLUSH FORALL GO_TO IF INQUIRE LOCK NULLIFY OPEN PRINT READ RETURN REWIND STOP SYNC_ALL SYNC_IMAGES SYNC_MEMORY UNLOCK WAIT WHERE WRITE INT_LITERAL_CONSTANT REAL_LITERAL_CONSTANT COMPLEX_LITERAL_CONSTANT LOGICAL_LITERAL_CONSTANT CHAR_LITERAL_CONSTANT BOZ_LITERAL_CONSTANT }
8_optlist_autogen	{ ',' PROCEDURE GENERIC FINAL }
intrinsic-operator	{ ')' }
142_opt_autogen	{ FORMAT ENTRY DATA ALLOCATE NAME_LITERAL BACKSPACE CALL CLOSE CONTINUE CYCLE DEALLOCATE END ENDFILE ERROR_STOP EXIT FLUSH FORALL GO_TO IF INQUIRE LOCK NULLIFY OPEN PRINT READ RETURN REWIND STOP SYNC_ALL SYNC_IMAGES SYNC_MEMORY UNLOCK WAIT WHERE WRITE INT_LITERAL_CONSTANT REAL_LITERAL_CONSTANT COMPLEX_LITERAL_CONSTANT LOGICAL_LITERAL_CONSTANT CHAR_LITERAL_CONSTANT BOZ_LITERAL_CONSTANT MODULE 'TYPE' 'CLASS' ELEMENTAL IMPURE PURE RECURSIVE INTEGER REAL DOUBLE_PRECISION COMPLEX CHARACTER LOGICAL END_INTERFACE PROGRAM SUBMODULE BLOCK_DATA MODULE_PROCEDURE }
primary	{ '*' }
209_group_autogen	{ }
75_group_autogen	{ NAME_LITERAL }
NAME_LITERAL10_opt_autogen	{ FORMAT ENTRY DATA ALLOCATE NAME_LITERAL BACKSPACE CALL CLOSE CONTINUE CYCLE DEALLOCATE END ENDFILE ERROR_STOP EXIT FLUSH FORALL GO_TO IF INQUIRE LOCK NULLIFY OPEN PRINT READ RETURN REWIND STOP SYNC_ALL SYNC_IMAGES SYNC_MEMORY UNLOCK WAIT WHERE WRITE INT_LITERAL_CONSTANT REAL_LITERAL_CONSTANT COMPLEX_LITERAL_CONSTANT LOGICAL_LITERAL_CONSTANT CHAR_LITERAL_CONSTANT BOZ_LITERAL_CONSTANT }
data-stmt-set	{ FORMAT ENTRY DATA ALLOCATE NAME_LITERAL BACKSPACE CALL CLOSE CONTINUE CYCLE DEALLOCATE END ENDFILE ERROR_STOP EXIT FLUSH FORALL GO_TO IF INQUIRE LOCK NULLIFY OPEN PRINT READ RETURN REWIND STOP SYNC_ALL SYNC_IMAGES SYNC_MEMORY UNLOCK WAIT WHERE WRITE INT_LITERAL_CONSTANT REAL_LITERAL_CONSTANT COMPLEX_LITERAL_CONSTANT LOGICAL_LITERAL_CONSTANT CHAR_LITERAL_CONSTANT BOZ_LITERAL_CONSTANT PARAMETER PROCEDURE 'TYPE' 'CLASS' ENUM INTERFACE ABSTRACT_INTERFACE PUBLIC PRIVATE ALLOCATABLE ASYNCHRONOUS BIND CODIMENSION COMMON DIMENSION EQUIVALENCE EXTERNAL INTENT INTRINSIC NAMELIST OPTIONAL POINTER PROTECTED SAVE TARGET VOLATILE VALUE INTEGER REAL DOUBLE_PRECISION COMPLEX CHARACTER LOGICAL }
57_opt_autogen	{ NAME_LITERAL }
forall-triplet-spec-list	{ ',' }
164_group_autogen	{ ')' }
actual-arg-spec-list1_opt_autogen	{ ')' }
connect-spec	{ ')' }
or-op	{ }
case-selector	{ NAME_LITERAL }
procedure-stmt	{ MODULE 'TYPE' 'CLASS' ELEMENTAL IMPURE PURE RECURSIVE INTEGER REAL DOUBLE_PRECISION COMPLEX CHARACTER LOGICAL END_INTERFACE }
168_group_autogen	{ ',' }
expr	{ ')' ',' ':' '.' '=' '%' FORMAT ENTRY DATA ALLOCATE NAME_LITERAL BACKSPACE CALL CLOSE CONTINUE CYCLE DEALLOCATE END ENDFILE ERROR_STOP EXIT FLUSH FORALL GO_TO IF INQUIRE LOCK NULLIFY OPEN PRINT READ RETURN REWIND STOP SYNC_ALL SYNC_IMAGES SYNC_MEMORY UNLOCK WAIT WHERE WRITE INT_LITERAL_CONSTANT REAL_LITERAL_CONSTANT COMPLEX_LITERAL_CONSTANT LOGICAL_LITERAL_CONSTANT CHAR_LITERAL_CONSTANT BOZ_LITERAL_CONSTANT PARAMETER PROCEDURE 'TYPE' 'CLASS' ENUM INTERFACE ABSTRACT_INTERFACE PUBLIC PRIVATE ALLOCATABLE ASYNCHRONOUS BIND CODIMENSION COMMON DIMENSION EQUIVALENCE EXTERNAL INTENT INTRINSIC NAMELIST OPTIONAL POINTER PROTECTED SAVE TARGET VOLATILE VALUE INTEGER REAL DOUBLE_PRECISION COMPLEX CHARACTER LOGICAL }
13_opt_autogen	{ ':' NAME_LITERAL }
129_opt_autogen	{ USE }
124_opt_autogen	{ ',' ')' }
62_optlist_autogen	{ ',' }
constant-subobject	{ '*' }
mp-subprogram-stmt	{ }
21_opt_autogen	{ NAME_LITERAL }
coindexed-named-object	{ '%' '*' '(' }
148_group_autogen	{ DO }
forall-body-construct	{ WHERE NAME_LITERAL FORALL INT_LITERAL_CONSTANT REAL_LITERAL_CONSTANT COMPLEX_LITERAL_CONSTANT LOGICAL_LITERAL_CONSTANT CHAR_LITERAL_CONSTANT BOZ_LITERAL_CONSTANT END_FORALL }
59_opt_autogen	{ '(' '%' }
contains-stmt	{ PRIVATE END }
53_opt_autogen	{ }
specification-part5_opt_autogen	{ END }
132_opt_autogen	{ PROGRAM MODULE SUBMODULE BLOCK_DATA 'TYPE' 'CLASS' ELEMENTAL IMPURE PURE RECURSIVE INTEGER REAL DOUBLE_PRECISION COMPLEX CHARACTER LOGICAL }
proc-attr-spec	{ }
type-spec	{ ':' ')' }
do-construct	{ FORMAT ENTRY DATA ALLOCATE NAME_LITERAL BACKSPACE CALL CLOSE CONTINUE CYCLE DEALLOCATE END ENDFILE ERROR_STOP EXIT FLUSH FORALL GO_TO IF INQUIRE LOCK NULLIFY OPEN PRINT READ RETURN REWIND STOP SYNC_ALL SYNC_IMAGES SYNC_MEMORY UNLOCK WAIT WHERE WRITE INT_LITERAL_CONSTANT REAL_LITERAL_CONSTANT COMPLEX_LITERAL_CONSTANT LOGICAL_LITERAL_CONSTANT CHAR_LITERAL_CONSTANT BOZ_LITERAL_CONSTANT }
masked-elsewhere-stmt	{ }
214_group_autogen	{ ',' ':' NAME_LITERAL }
codimension-decl	{ ENTRY FORMAT PARAMETER PROCEDURE 'TYPE' 'CLASS' NAME_LITERAL ENUM INTERFACE ABSTRACT_INTERFACE PUBLIC PRIVATE ALLOCATABLE ASYNCHRONOUS BIND CODIMENSION COMMON DATA DIMENSION EQUIVALENCE EXTERNAL INTENT INTRINSIC NAMELIST OPTIONAL POINTER PROTECTED SAVE TARGET VOLATILE VALUE INTEGER REAL DOUBLE_PRECISION COMPLEX CHARACTER LOGICAL }
36_group_autogen	{ ',' }
63_optlist_autogen	{ ',' ')' }
parent-string	{ '(' }
specification-part2_opt_autogen	{ ALLOCATE NAME_LITERAL BACKSPACE CALL CLOSE CONTINUE CYCLE DEALLOCATE END ENDFILE ERROR_STOP EXIT FLUSH FORALL GO_TO IF INQUIRE LOCK NULLIFY OPEN PRINT READ RETURN REWIND STOP SYNC_ALL SYNC_IMAGES SYNC_MEMORY UNLOCK WAIT WHERE WRITE INT_LITERAL_CONSTANT REAL_LITERAL_CONSTANT COMPLEX_LITERAL_CONSTANT LOGICAL_LITERAL_CONSTANT CHAR_LITERAL_CONSTANT BOZ_LITERAL_CONSTANT }
upper-cobound	{ ',' }
subscript2_opt_autogen	{ ':' }
122_group_autogen	{ ')' }
if-construct	{ FORMAT ENTRY DATA ALLOCATE NAME_LITERAL BACKSPACE CALL CLOSE CONTINUE CYCLE DEALLOCATE END ENDFILE ERROR_STOP EXIT FLUSH FORALL GO_TO IF INQUIRE LOCK NULLIFY OPEN PRINT READ RETURN REWIND STOP SYNC_ALL SYNC_IMAGES SYNC_MEMORY UNLOCK WAIT WHERE WRITE INT_LITERAL_CONSTANT REAL_LITERAL_CONSTANT COMPLEX_LITERAL_CONSTANT LOGICAL_LITERAL_CONSTANT CHAR_LITERAL_CONSTANT BOZ_LITERAL_CONSTANT }
100_group_autogen	{ }
112_group_autogen	{ }
58_optlist_autogen	{ CASE END_SELECT }
12_opt_autogen	{ }
99_group_autogen	{ ',' }
save-stmt	{ ENTRY FORMAT PARAMETER PROCEDURE 'TYPE' 'CLASS' NAME_LITERAL ENUM INTERFACE ABSTRACT_INTERFACE PUBLIC PRIVATE ALLOCATABLE ASYNCHRONOUS BIND CODIMENSION COMMON DATA DIMENSION EQUIVALENCE EXTERNAL INTENT INTRINSIC NAMELIST OPTIONAL POINTER PROTECTED SAVE TARGET VOLATILE VALUE INTEGER REAL DOUBLE_PRECISION COMPLEX CHARACTER LOGICAL }
structure-component	{ '%' '*' '(' }
end-block-stmt	{ FORMAT ENTRY DATA ALLOCATE NAME_LITERAL BACKSPACE CALL CLOSE CONTINUE CYCLE DEALLOCATE END ENDFILE ERROR_STOP EXIT FLUSH FORALL GO_TO IF INQUIRE LOCK NULLIFY OPEN PRINT READ RETURN REWIND STOP SYNC_ALL SYNC_IMAGES SYNC_MEMORY UNLOCK WAIT WHERE WRITE INT_LITERAL_CONSTANT REAL_LITERAL_CONSTANT COMPLEX_LITERAL_CONSTANT LOGICAL_LITERAL_CONSTANT CHAR_LITERAL_CONSTANT BOZ_LITERAL_CONSTANT }
decimal-edit-desc	{ ',' ')' }
190_group_autogen	{ ',' }
dealloc-opt-list	{ }
','2_opt_autogen	{ NAME_LITERAL '(' INT_LITERAL_CONSTANT REAL_LITERAL_CONSTANT COMPLEX_LITERAL_CONSTANT LOGICAL_LITERAL_CONSTANT CHAR_LITERAL_CONSTANT BOZ_LITERAL_CONSTANT }
107_opt_autogen	{ FORMAT ENTRY DATA ALLOCATE NAME_LITERAL BACKSPACE CALL CLOSE CONTINUE CYCLE DEALLOCATE END ENDFILE ERROR_STOP EXIT FLUSH FORALL GO_TO IF INQUIRE LOCK NULLIFY OPEN PRINT READ RETURN REWIND STOP SYNC_ALL SYNC_IMAGES SYNC_MEMORY UNLOCK WAIT WHERE WRITE INT_LITERAL_CONSTANT REAL_LITERAL_CONSTANT COMPLEX_LITERAL_CONSTANT LOGICAL_LITERAL_CONSTANT CHAR_LITERAL_CONSTANT BOZ_LITERAL_CONSTANT }
34_group_autogen	{ ',' }
generic-spec1_opt_autogen	{ }
44_optlist_autogen	{ ',' ']' }
121_opt_autogen	{ ',' ')' }
proc-language-binding-spec1_opt_autogen	{ }
96_opt_autogen	{ SELECT_CASE }
181_group_autogen	{ }
228_group_autogen	{ }
141_opt_autogen	{ }
38_group_autogen	{ NAME_LITERAL ',' ':' }
allocate-shape-spec	{ ')' }
43_optlist_autogen	{ ',' ')' }
13_group_autogen	{ ',' }
26_group_autogen	{ NAME_LITERAL }
data-ref	{ '(' '%' '*' ',' }
162_group_autogen	{ ')' }
9_optlist_autogen	{ ',' ':' }
flush-stmt	{ FORMAT ENTRY DATA ALLOCATE NAME_LITERAL BACKSPACE CALL CLOSE CONTINUE CYCLE DEALLOCATE END ENDFILE ERROR_STOP EXIT FLUSH FORALL GO_TO IF INQUIRE LOCK NULLIFY OPEN PRINT READ RETURN REWIND STOP SYNC_ALL SYNC_IMAGES SYNC_MEMORY UNLOCK WAIT WHERE WRITE INT_LITERAL_CONSTANT REAL_LITERAL_CONSTANT COMPLEX_LITERAL_CONSTANT LOGICAL_LITERAL_CONSTANT CHAR_LITERAL_CONSTANT BOZ_LITERAL_CONSTANT }
136_group_autogen	{ ELSEWHERE }
70_group_autogen	{ ',' }
139_opt_autogen	{ FORMAT ENTRY DATA ALLOCATE NAME_LITERAL BACKSPACE CALL CLOSE CONTINUE CYCLE DEALLOCATE END ENDFILE ERROR_STOP EXIT FLUSH FORALL GO_TO IF INQUIRE LOCK NULLIFY OPEN PRINT READ RETURN REWIND STOP SYNC_ALL SYNC_IMAGES SYNC_MEMORY UNLOCK WAIT WHERE WRITE INT_LITERAL_CONSTANT REAL_LITERAL_CONSTANT COMPLEX_LITERAL_CONSTANT LOGICAL_LITERAL_CONSTANT CHAR_LITERAL_CONSTANT BOZ_LITERAL_CONSTANT }
function-reference	{ }
end-mp-subprogram-stmt	{ FORMAT ENTRY DATA ALLOCATE NAME_LITERAL BACKSPACE CALL CLOSE CONTINUE CYCLE DEALLOCATE END ENDFILE ERROR_STOP EXIT FLUSH FORALL GO_TO IF INQUIRE LOCK NULLIFY OPEN PRINT READ RETURN REWIND STOP SYNC_ALL SYNC_IMAGES SYNC_MEMORY UNLOCK WAIT WHERE WRITE INT_LITERAL_CONSTANT REAL_LITERAL_CONSTANT COMPLEX_LITERAL_CONSTANT LOGICAL_LITERAL_CONSTANT CHAR_LITERAL_CONSTANT BOZ_LITERAL_CONSTANT MODULE_PROCEDURE 'TYPE' 'CLASS' ELEMENTAL IMPURE MODULE PURE RECURSIVE INTEGER REAL DOUBLE_PRECISION COMPLEX CHARACTER LOGICAL }
type-bound-generic-stmt	{ PROCEDURE GENERIC FINAL }
ac-implied-do	{ }
component-def-stmt1_optlist_autogen	{ 'TYPE' 'CLASS' PROCEDURE INTEGER REAL DOUBLE_PRECISION COMPLEX CHARACTER LOGICAL CONTAINS }
22_group_autogen	{ ',' }
105_group_autogen	{ ',' }
allocatable-stmt	{ ENTRY FORMAT PARAMETER PROCEDURE 'TYPE' 'CLASS' NAME_LITERAL ENUM INTERFACE ABSTRACT_INTERFACE PUBLIC PRIVATE ALLOCATABLE ASYNCHRONOUS BIND CODIMENSION COMMON DATA DIMENSION EQUIVALENCE EXTERNAL INTENT INTRINSIC NAMELIST OPTIONAL POINTER PROTECTED SAVE TARGET VOLATILE VALUE INTEGER REAL DOUBLE_PRECISION COMPLEX CHARACTER LOGICAL }
26_opt_autogen	{ '*' }
31_group_autogen	{ ',' }
56_group_autogen	{ ',' }
program-unit1_list_autogen	{ PROGRAM MODULE SUBMODULE BLOCK_DATA 'TYPE' 'CLASS' ELEMENTAL IMPURE PURE RECURSIVE INTEGER REAL DOUBLE_PRECISION COMPLEX CHARACTER LOGICAL _FINISH_ }
end-submodule-stmt	{ PROGRAM MODULE SUBMODULE BLOCK_DATA 'TYPE' 'CLASS' ELEMENTAL IMPURE PURE RECURSIVE INTEGER REAL DOUBLE_PRECISION COMPLEX CHARACTER LOGICAL }
end-critical-stmt	{ FORMAT ENTRY DATA ALLOCATE NAME_LITERAL BACKSPACE CALL CLOSE CONTINUE CYCLE DEALLOCATE END ENDFILE ERROR_STOP EXIT FLUSH FORALL GO_TO IF INQUIRE LOCK NULLIFY OPEN PRINT READ RETURN REWIND STOP SYNC_ALL SYNC_IMAGES SYNC_MEMORY UNLOCK WAIT WHERE WRITE INT_LITERAL_CONSTANT REAL_LITERAL_CONSTANT COMPLEX_LITERAL_CONSTANT LOGICAL_LITERAL_CONSTANT CHAR_LITERAL_CONSTANT BOZ_LITERAL_CONSTANT }
pointer-assignment-stmt	{ FORMAT ENTRY DATA ALLOCATE NAME_LITERAL BACKSPACE CALL CLOSE CONTINUE CYCLE DEALLOCATE END ENDFILE ERROR_STOP EXIT FLUSH FORALL GO_TO IF INQUIRE LOCK NULLIFY OPEN PRINT READ RETURN REWIND STOP SYNC_ALL SYNC_IMAGES SYNC_MEMORY UNLOCK WAIT WHERE WRITE INT_LITERAL_CONSTANT REAL_LITERAL_CONSTANT COMPLEX_LITERAL_CONSTANT LOGICAL_LITERAL_CONSTANT CHAR_LITERAL_CONSTANT BOZ_LITERAL_CONSTANT END_FORALL }
215_group_autogen	{ }
75_opt_autogen	{ }
letter-spec-list	{ ')' }
111_group_autogen	{ '[' }
end-select-type-stmt	{ FORMAT ENTRY DATA ALLOCATE NAME_LITERAL BACKSPACE CALL CLOSE CONTINUE CYCLE DEALLOCATE END ENDFILE ERROR_STOP EXIT FLUSH FORALL GO_TO IF INQUIRE LOCK NULLIFY OPEN PRINT READ RETURN REWIND STOP SYNC_ALL SYNC_IMAGES SYNC_MEMORY UNLOCK WAIT WHERE WRITE INT_LITERAL_CONSTANT REAL_LITERAL_CONSTANT COMPLEX_LITERAL_CONSTANT LOGICAL_LITERAL_CONSTANT CHAR_LITERAL_CONSTANT BOZ_LITERAL_CONSTANT }
12_group_autogen	{ ':' NAME_LITERAL }
actual-arg-spec-list	{ ')' }
pointer-decl	{ ENTRY FORMAT PARAMETER PROCEDURE 'TYPE' 'CLASS' NAME_LITERAL ENUM INTERFACE ABSTRACT_INTERFACE PUBLIC PRIVATE ALLOCATABLE ASYNCHRONOUS BIND CODIMENSION COMMON DATA DIMENSION EQUIVALENCE EXTERNAL INTENT INTRINSIC NAMELIST OPTIONAL POINTER PROTECTED SAVE TARGET VOLATILE VALUE INTEGER REAL DOUBLE_PRECISION COMPLEX CHARACTER LOGICAL }
160_group_autogen	{ }
48_opt_autogen	{ }
14_optlist_autogen	{ ',' ':' }
223_group_autogen	{ }
116_group_autogen	{ ',' }
199_group_autogen	{ }
dimension-stmt	{ ENTRY FORMAT PARAMETER PROCEDURE 'TYPE' 'CLASS' NAME_LITERAL ENUM INTERFACE ABSTRACT_INTERFACE PUBLIC PRIVATE ALLOCATABLE ASYNCHRONOUS BIND CODIMENSION COMMON DATA DIMENSION EQUIVALENCE EXTERNAL INTENT INTRINSIC NAMELIST OPTIONAL POINTER PROTECTED SAVE TARGET VOLATILE VALUE INTEGER REAL DOUBLE_PRECISION COMPLEX CHARACTER LOGICAL }
64_group_autogen	{ NAME_LITERAL '/' }
106_opt_autogen	{ FORMAT ENTRY DATA ALLOCATE NAME_LITERAL BACKSPACE CALL CLOSE CONTINUE CYCLE DEALLOCATE END ENDFILE ERROR_STOP EXIT FLUSH FORALL GO_TO IF INQUIRE LOCK NULLIFY OPEN PRINT READ RETURN REWIND STOP SYNC_ALL SYNC_IMAGES SYNC_MEMORY UNLOCK WAIT WHERE WRITE INT_LITERAL_CONSTANT REAL_LITERAL_CONSTANT COMPLEX_LITERAL_CONSTANT LOGICAL_LITERAL_CONSTANT CHAR_LITERAL_CONSTANT BOZ_LITERAL_CONSTANT }
28_group_autogen	{ '*' ':' }
126_group_autogen	{ }
69_opt_autogen	{ '*' }
block-data	{ PROGRAM MODULE SUBMODULE BLOCK_DATA 'TYPE' 'CLASS' ELEMENTAL IMPURE PURE RECURSIVE INTEGER REAL DOUBLE_PRECISION COMPLEX CHARACTER LOGICAL }
open-stmt	{ FORMAT ENTRY DATA ALLOCATE NAME_LITERAL BACKSPACE CALL CLOSE CONTINUE CYCLE DEALLOCATE END ENDFILE ERROR_STOP EXIT FLUSH FORALL GO_TO IF INQUIRE LOCK NULLIFY OPEN PRINT READ RETURN REWIND STOP SYNC_ALL SYNC_IMAGES SYNC_MEMORY UNLOCK WAIT WHERE WRITE INT_LITERAL_CONSTANT REAL_LITERAL_CONSTANT COMPLEX_LITERAL_CONSTANT LOGICAL_LITERAL_CONSTANT CHAR_LITERAL_CONSTANT BOZ_LITERAL_CONSTANT }
227_group_autogen	{ }
end-program-stmt	{ FORMAT ENTRY DATA ALLOCATE NAME_LITERAL BACKSPACE CALL CLOSE CONTINUE CYCLE DEALLOCATE END ENDFILE ERROR_STOP EXIT FLUSH FORALL GO_TO IF INQUIRE LOCK NULLIFY OPEN PRINT READ RETURN REWIND STOP SYNC_ALL SYNC_IMAGES SYNC_MEMORY UNLOCK WAIT WHERE WRITE INT_LITERAL_CONSTANT REAL_LITERAL_CONSTANT COMPLEX_LITERAL_CONSTANT LOGICAL_LITERAL_CONSTANT CHAR_LITERAL_CONSTANT BOZ_LITERAL_CONSTANT PROGRAM MODULE SUBMODULE BLOCK_DATA 'TYPE' 'CLASS' ELEMENTAL IMPURE PURE RECURSIVE INTEGER REAL DOUBLE_PRECISION COMPLEX CHARACTER LOGICAL }
172_group_autogen	{ }
57_group_autogen	{ NAME_LITERAL OPERATOR ASSIGNMENT READ WRITE }
220_group_autogen	{ NAME_LITERAL '*' INT_LITERAL_CONSTANT REAL_LITERAL_CONSTANT COMPLEX_LITERAL_CONSTANT LOGICAL_LITERAL_CONSTANT CHAR_LITERAL_CONSTANT BOZ_LITERAL_CONSTANT }
execution-part-construct1_optlist_autogen	{ FORMAT ENTRY DATA ALLOCATE NAME_LITERAL BACKSPACE CALL CLOSE CONTINUE CYCLE DEALLOCATE END ENDFILE ERROR_STOP EXIT FLUSH FORALL GO_TO IF INQUIRE LOCK NULLIFY OPEN PRINT READ RETURN REWIND STOP SYNC_ALL SYNC_IMAGES SYNC_MEMORY UNLOCK WAIT WHERE WRITE INT_LITERAL_CONSTANT REAL_LITERAL_CONSTANT COMPLEX_LITERAL_CONSTANT LOGICAL_LITERAL_CONSTANT CHAR_LITERAL_CONSTANT BOZ_LITERAL_CONSTANT }
66_optlist_autogen	{ ',' }
103_opt_autogen	{ ')' }
end-where-stmt	{ FORMAT ENTRY DATA ALLOCATE NAME_LITERAL BACKSPACE CALL CLOSE CONTINUE CYCLE DEALLOCATE END ENDFILE ERROR_STOP EXIT FLUSH FORALL GO_TO IF INQUIRE LOCK NULLIFY OPEN PRINT READ RETURN REWIND STOP SYNC_ALL SYNC_IMAGES SYNC_MEMORY UNLOCK WAIT WHERE WRITE INT_LITERAL_CONSTANT REAL_LITERAL_CONSTANT COMPLEX_LITERAL_CONSTANT LOGICAL_LITERAL_CONSTANT CHAR_LITERAL_CONSTANT BOZ_LITERAL_CONSTANT }
3_group_autogen	{ }
NAME_LITERAL12_opt_autogen	{ FORMAT ENTRY DATA ALLOCATE NAME_LITERAL BACKSPACE CALL CLOSE CONTINUE CYCLE DEALLOCATE END ENDFILE ERROR_STOP EXIT FLUSH FORALL GO_TO IF INQUIRE LOCK NULLIFY OPEN PRINT READ RETURN REWIND STOP SYNC_ALL SYNC_IMAGES SYNC_MEMORY UNLOCK WAIT WHERE WRITE INT_LITERAL_CONSTANT REAL_LITERAL_CONSTANT COMPLEX_LITERAL_CONSTANT LOGICAL_LITERAL_CONSTANT CHAR_LITERAL_CONSTANT BOZ_LITERAL_CONSTANT }
lock-stmt	{ FORMAT ENTRY DATA ALLOCATE NAME_LITERAL BACKSPACE CALL CLOSE CONTINUE CYCLE DEALLOCATE END ENDFILE ERROR_STOP EXIT FLUSH FORALL GO_TO IF INQUIRE LOCK NULLIFY OPEN PRINT READ RETURN REWIND STOP SYNC_ALL SYNC_IMAGES SYNC_MEMORY UNLOCK WAIT WHERE WRITE INT_LITERAL_CONSTANT REAL_LITERAL_CONSTANT COMPLEX_LITERAL_CONSTANT LOGICAL_LITERAL_CONSTANT CHAR_LITERAL_CONSTANT BOZ_LITERAL_CONSTANT }
only	{ }
module-subprogram-part1_opt_autogen	{ END }
','6_opt_autogen	{ WHILE }
sequence-stmt	{ PRIVATE SEQUENCE }
120_group_autogen	{ ',' }
174_group_autogen	{ INT_LITERAL_CONSTANT '*' }
180_group_autogen	{ }
select-type-stmt	{ }
interface-specification	{ MODULE 'TYPE' 'CLASS' ELEMENTAL IMPURE PURE RECURSIVE INTEGER REAL DOUBLE_PRECISION COMPLEX CHARACTER LOGICAL END_INTERFACE }
program-stmt1_opt_autogen	{ }
153_group_autogen	{ IF }
53_group_autogen	{ '*' }
72_group_autogen	{ ',' }
execution-part-construct2_optlist_autogen	{ FORMAT ENTRY DATA ALLOCATE NAME_LITERAL BACKSPACE CALL CLOSE CONTINUE CYCLE DEALLOCATE END ENDFILE ERROR_STOP EXIT FLUSH FORALL GO_TO IF INQUIRE LOCK NULLIFY OPEN PRINT READ RETURN REWIND STOP SYNC_ALL SYNC_IMAGES SYNC_MEMORY UNLOCK WAIT WHERE WRITE INT_LITERAL_CONSTANT REAL_LITERAL_CONSTANT COMPLEX_LITERAL_CONSTANT LOGICAL_LITERAL_CONSTANT CHAR_LITERAL_CONSTANT BOZ_LITERAL_CONSTANT END_ASSOCIATE END_BLOCK END_CRITICAL END_DO }
not-op	{ }
implicit-part	{ }
156_group_autogen	{ ',' }
7_opt_autogen	{ }
equiv-operand	{ OR EQV NEQV }
data-i-do-object	{ ',' }
115_group_autogen	{ }
assignment-stmt	{ FORMAT ENTRY DATA ALLOCATE NAME_LITERAL BACKSPACE CALL CLOSE CONTINUE CYCLE DEALLOCATE END ENDFILE ERROR_STOP EXIT FLUSH FORALL GO_TO IF INQUIRE LOCK NULLIFY OPEN PRINT READ RETURN REWIND STOP SYNC_ALL SYNC_IMAGES SYNC_MEMORY UNLOCK WAIT WHERE WRITE INT_LITERAL_CONSTANT REAL_LITERAL_CONSTANT COMPLEX_LITERAL_CONSTANT LOGICAL_LITERAL_CONSTANT CHAR_LITERAL_CONSTANT BOZ_LITERAL_CONSTANT END_FORALL }
5_optlist_autogen	{ ',' }
NAME_LITERAL20_opt_autogen	{ }
execution-part1_opt_autogen	{ CONTAINS }
NAME_LITERAL28_opt_autogen	{ }
sufix1_opt_autogen	{ }
65_optlist_autogen	{ ',' ')' }
type-bound-proc-binding1_optlist_autogen	{ PROCEDURE GENERIC FINAL END_TYPE }
letter-spec	{ ')' }
sync-all-stmt	{ FORMAT ENTRY DATA ALLOCATE NAME_LITERAL BACKSPACE CALL CLOSE CONTINUE CYCLE DEALLOCATE END ENDFILE ERROR_STOP EXIT FLUSH FORALL GO_TO IF INQUIRE LOCK NULLIFY OPEN PRINT READ RETURN REWIND STOP SYNC_ALL SYNC_IMAGES SYNC_MEMORY UNLOCK WAIT WHERE WRITE INT_LITERAL_CONSTANT REAL_LITERAL_CONSTANT COMPLEX_LITERAL_CONSTANT LOGICAL_LITERAL_CONSTANT CHAR_LITERAL_CONSTANT BOZ_LITERAL_CONSTANT }
16_optlist_autogen	{ ',' ']' }
k	{ 'P' }
enumerator-def-stmt	{ ENUMERATOR END_ENUM }
format-stmt	{ IMPLICIT IMPLICIT_NONE PARAMETER FORMAT ENTRY PROCEDURE 'TYPE' 'CLASS' NAME_LITERAL ENUM INTERFACE ABSTRACT_INTERFACE PUBLIC PRIVATE ALLOCATABLE ASYNCHRONOUS BIND CODIMENSION COMMON DATA DIMENSION EQUIVALENCE EXTERNAL INTENT INTRINSIC NAMELIST OPTIONAL POINTER PROTECTED SAVE TARGET VOLATILE VALUE INTEGER REAL DOUBLE_PRECISION COMPLEX CHARACTER LOGICAL ALLOCATE BACKSPACE CALL CLOSE CONTINUE CYCLE DEALLOCATE END ENDFILE ERROR_STOP EXIT FLUSH FORALL GO_TO IF INQUIRE LOCK NULLIFY OPEN PRINT READ RETURN REWIND STOP SYNC_ALL SYNC_IMAGES SYNC_MEMORY UNLOCK WAIT WHERE WRITE INT_LITERAL_CONSTANT REAL_LITERAL_CONSTANT COMPLEX_LITERAL_CONSTANT LOGICAL_LITERAL_CONSTANT CHAR_LITERAL_CONSTANT BOZ_LITERAL_CONSTANT }
codimension-decl-list	{ ENTRY FORMAT PARAMETER PROCEDURE 'TYPE' 'CLASS' NAME_LITERAL ENUM INTERFACE ABSTRACT_INTERFACE PUBLIC PRIVATE ALLOCATABLE ASYNCHRONOUS BIND CODIMENSION COMMON DATA DIMENSION EQUIVALENCE EXTERNAL INTENT INTRINSIC NAMELIST OPTIONAL POINTER PROTECTED SAVE TARGET VOLATILE VALUE INTEGER REAL DOUBLE_PRECISION COMPLEX CHARACTER LOGICAL }
17_group_autogen	{ ',' }
67_optlist_autogen	{ ',' }
33_optlist_autogen	{ ',' ENTRY FORMAT PARAMETER PROCEDURE 'TYPE' 'CLASS' NAME_LITERAL ENUM INTERFACE ABSTRACT_INTERFACE PUBLIC PRIVATE ALLOCATABLE ASYNCHRONOUS BIND CODIMENSION COMMON DATA DIMENSION EQUIVALENCE EXTERNAL INTENT INTRINSIC NAMELIST OPTIONAL POINTER PROTECTED SAVE TARGET VOLATILE VALUE INTEGER REAL DOUBLE_PRECISION COMPLEX CHARACTER LOGICAL }
4_opt_autogen	{ '*' ':' }
20_group_autogen	{ ':' NAME_LITERAL }
char-string-edit-desc	{ ',' ')' }
89_group_autogen	{ ',' }
48_optlist_autogen	{ ',' ')' }
allocate-shape-spec-list	{ ')' }
104_opt_autogen	{ }
deferred-shape-spec-list	{ ')' }
78_group_autogen	{ NAME_LITERAL }
145_opt_autogen	{ FORMAT ENTRY DATA ALLOCATE NAME_LITERAL BACKSPACE CALL CLOSE CONTINUE CYCLE DEALLOCATE END ENDFILE ERROR_STOP EXIT FLUSH FORALL GO_TO IF INQUIRE LOCK NULLIFY OPEN PRINT READ RETURN REWIND STOP SYNC_ALL SYNC_IMAGES SYNC_MEMORY UNLOCK WAIT WHERE WRITE INT_LITERAL_CONSTANT REAL_LITERAL_CONSTANT COMPLEX_LITERAL_CONSTANT LOGICAL_LITERAL_CONSTANT CHAR_LITERAL_CONSTANT BOZ_LITERAL_CONSTANT MODULE_PROCEDURE 'TYPE' 'CLASS' ELEMENTAL IMPURE MODULE PURE RECURSIVE INTEGER REAL DOUBLE_PRECISION COMPLEX CHARACTER LOGICAL }
loop-control1_opt_autogen	{ }
NAME_LITERAL18_opt_autogen	{ }
42_group_autogen	{ }
183_group_autogen	{ }
data-stmt	{ FORMAT ENTRY DATA ALLOCATE NAME_LITERAL BACKSPACE CALL CLOSE CONTINUE CYCLE DEALLOCATE END ENDFILE ERROR_STOP EXIT FLUSH FORALL GO_TO IF INQUIRE LOCK NULLIFY OPEN PRINT READ RETURN REWIND STOP SYNC_ALL SYNC_IMAGES SYNC_MEMORY UNLOCK WAIT WHERE WRITE INT_LITERAL_CONSTANT REAL_LITERAL_CONSTANT COMPLEX_LITERAL_CONSTANT LOGICAL_LITERAL_CONSTANT CHAR_LITERAL_CONSTANT BOZ_LITERAL_CONSTANT PARAMETER PROCEDURE 'TYPE' 'CLASS' ENUM INTERFACE ABSTRACT_INTERFACE PUBLIC PRIVATE ALLOCATABLE ASYNCHRONOUS BIND CODIMENSION COMMON DIMENSION EQUIVALENCE EXTERNAL INTENT INTRINSIC NAMELIST OPTIONAL POINTER PROTECTED SAVE TARGET VOLATILE VALUE INTEGER REAL DOUBLE_PRECISION COMPLEX CHARACTER LOGICAL }
127_group_autogen	{ }
where-body-construct1_optlist_autogen	{ WHERE NAME_LITERAL INT_LITERAL_CONSTANT REAL_LITERAL_CONSTANT COMPLEX_LITERAL_CONSTANT LOGICAL_LITERAL_CONSTANT CHAR_LITERAL_CONSTANT BOZ_LITERAL_CONSTANT }
scalar-structure-component	{ '(' }
60_optlist_autogen	{ TYPE_IS CLASS_IS CLASS_DEFAULT END_SELECT }
18_opt_autogen	{ ')' '(' ':' }
deallocate-stmt	{ FORMAT ENTRY DATA ALLOCATE NAME_LITERAL BACKSPACE CALL CLOSE CONTINUE CYCLE DEALLOCATE END ENDFILE ERROR_STOP EXIT FLUSH FORALL GO_TO IF INQUIRE LOCK NULLIFY OPEN PRINT READ RETURN REWIND STOP SYNC_ALL SYNC_IMAGES SYNC_MEMORY UNLOCK WAIT WHERE WRITE INT_LITERAL_CONSTANT REAL_LITERAL_CONSTANT COMPLEX_LITERAL_CONSTANT LOGICAL_LITERAL_CONSTANT CHAR_LITERAL_CONSTANT BOZ_LITERAL_CONSTANT }
specification-part	{ ALLOCATE NAME_LITERAL BACKSPACE CALL CLOSE CONTINUE CYCLE DEALLOCATE END ENDFILE ERROR_STOP EXIT FLUSH FORALL GO_TO IF INQUIRE LOCK NULLIFY OPEN PRINT READ RETURN REWIND STOP SYNC_ALL SYNC_IMAGES SYNC_MEMORY UNLOCK WAIT WHERE WRITE INT_LITERAL_CONSTANT REAL_LITERAL_CONSTANT COMPLEX_LITERAL_CONSTANT LOGICAL_LITERAL_CONSTANT CHAR_LITERAL_CONSTANT BOZ_LITERAL_CONSTANT CONTAINS }
computed-goto-stmt	{ FORMAT ENTRY DATA ALLOCATE NAME_LITERAL BACKSPACE CALL CLOSE CONTINUE CYCLE DEALLOCATE END ENDFILE ERROR_STOP EXIT FLUSH FORALL GO_TO IF INQUIRE LOCK NULLIFY OPEN PRINT READ RETURN REWIND STOP SYNC_ALL SYNC_IMAGES SYNC_MEMORY UNLOCK WAIT WHERE WRITE INT_LITERAL_CONSTANT REAL_LITERAL_CONSTANT COMPLEX_LITERAL_CONSTANT LOGICAL_LITERAL_CONSTANT CHAR_LITERAL_CONSTANT BOZ_LITERAL_CONSTANT }
14_group_autogen	{ '[' }
77_group_autogen	{ NAME_LITERAL }
assumed-shape-spec-list	{ ')' }
execution-part4_opt_autogen	{ CONTAINS }
proc-pointer-object	{ '=' }
cosubscript	{ ']' }
flush-spec-list	{ ')' }
equivalence-object	{ ',' ')' }
28_opt_autogen	{ }
only-use-name	{ }
declaration-type-spec	{ ',' '(' ')' 'TYPE' 'CLASS' ELEMENTAL IMPURE MODULE PURE RECURSIVE INTEGER REAL DOUBLE_PRECISION COMPLEX CHARACTER LOGICAL }
allocate-object-list	{ ',' }
75_optlist_autogen	{ ',' }
106_group_autogen	{ }
block-do-construct	{ FORMAT ENTRY DATA ALLOCATE NAME_LITERAL BACKSPACE CALL CLOSE CONTINUE CYCLE DEALLOCATE END ENDFILE ERROR_STOP EXIT FLUSH FORALL GO_TO IF INQUIRE LOCK NULLIFY OPEN PRINT READ RETURN REWIND STOP SYNC_ALL SYNC_IMAGES SYNC_MEMORY UNLOCK WAIT WHERE WRITE INT_LITERAL_CONSTANT REAL_LITERAL_CONSTANT COMPLEX_LITERAL_CONSTANT LOGICAL_LITERAL_CONSTANT CHAR_LITERAL_CONSTANT BOZ_LITERAL_CONSTANT }
specification-part1_opt_autogen	{ }
53_optlist_autogen	{ ',' ')' }
54_group_autogen	{ ',' }
complex-part-designator	{ '%' '*' }
stride	{ }
do-term-shared-stmt	{ FORMAT ENTRY DATA ALLOCATE NAME_LITERAL BACKSPACE CALL CLOSE CONTINUE CYCLE DEALLOCATE END ENDFILE ERROR_STOP EXIT FLUSH FORALL GO_TO IF INQUIRE LOCK NULLIFY OPEN PRINT READ RETURN REWIND STOP SYNC_ALL SYNC_IMAGES SYNC_MEMORY UNLOCK WAIT WHERE WRITE INT_LITERAL_CONSTANT REAL_LITERAL_CONSTANT COMPLEX_LITERAL_CONSTANT LOGICAL_LITERAL_CONSTANT CHAR_LITERAL_CONSTANT BOZ_LITERAL_CONSTANT }
212_group_autogen	{ NAME_LITERAL }
end-module-stmt	{ PROGRAM MODULE SUBMODULE BLOCK_DATA 'TYPE' 'CLASS' ELEMENTAL IMPURE PURE RECURSIVE INTEGER REAL DOUBLE_PRECISION COMPLEX CHARACTER LOGICAL }
sign	{ INT_LITERAL_CONSTANT REAL_LITERAL_CONSTANT }
185_group_autogen	{ }
structure-constructor	{ }
binding-attr	{ ':' }
prefix-spec	{ 'TYPE' 'CLASS' ELEMENTAL IMPURE MODULE PURE RECURSIVE INTEGER REAL DOUBLE_PRECISION COMPLEX CHARACTER LOGICAL }
type-param-value	{ ',' ')' }
type-param-decl-list	{ INTEGER }
subroutine-stmt	{ }
NAME_LITERAL5_opt_autogen	{ }
57_optlist_autogen	{ ELSE_IF ELSE }
format	{ ',' FORMAT ENTRY DATA ALLOCATE NAME_LITERAL BACKSPACE CALL CLOSE CONTINUE CYCLE DEALLOCATE END ENDFILE ERROR_STOP EXIT FLUSH FORALL GO_TO IF INQUIRE LOCK NULLIFY OPEN PRINT READ RETURN REWIND STOP SYNC_ALL SYNC_IMAGES SYNC_MEMORY UNLOCK WAIT WHERE WRITE INT_LITERAL_CONSTANT REAL_LITERAL_CONSTANT COMPLEX_LITERAL_CONSTANT LOGICAL_LITERAL_CONSTANT CHAR_LITERAL_CONSTANT BOZ_LITERAL_CONSTANT }
76_group_autogen	{ ',' }
173_group_autogen	{ '*' NAME_LITERAL INT_LITERAL_CONSTANT REAL_LITERAL_CONSTANT COMPLEX_LITERAL_CONSTANT LOGICAL_LITERAL_CONSTANT CHAR_LITERAL_CONSTANT BOZ_LITERAL_CONSTANT }
NAME_LITERAL21_opt_autogen	{ FORMAT ENTRY DATA ALLOCATE NAME_LITERAL BACKSPACE CALL CLOSE CONTINUE CYCLE DEALLOCATE END ENDFILE ERROR_STOP EXIT FLUSH FORALL GO_TO IF INQUIRE LOCK NULLIFY OPEN PRINT READ RETURN REWIND STOP SYNC_ALL SYNC_IMAGES SYNC_MEMORY UNLOCK WAIT WHERE WRITE INT_LITERAL_CONSTANT REAL_LITERAL_CONSTANT COMPLEX_LITERAL_CONSTANT LOGICAL_LITERAL_CONSTANT CHAR_LITERAL_CONSTANT BOZ_LITERAL_CONSTANT }
proc-component-attr-spec-list	{ ':' }
149_group_autogen	{ DO }
type-attr-spec	{ }
intent-spec	{ ')' }
prefix2_opt_autogen	{ SUBROUTINE }
select-case-stmt	{ }
115_opt_autogen	{ }
52_opt_autogen	{ '[' }
92_group_autogen	{ ',' }
sign-edit-desc	{ ',' ')' }
select-type-construct	{ FORMAT ENTRY DATA ALLOCATE NAME_LITERAL BACKSPACE CALL CLOSE CONTINUE CYCLE DEALLOCATE END ENDFILE ERROR_STOP EXIT FLUSH FORALL GO_TO IF INQUIRE LOCK NULLIFY OPEN PRINT READ RETURN REWIND STOP SYNC_ALL SYNC_IMAGES SYNC_MEMORY UNLOCK WAIT WHERE WRITE INT_LITERAL_CONSTANT REAL_LITERAL_CONSTANT COMPLEX_LITERAL_CONSTANT LOGICAL_LITERAL_CONSTANT CHAR_LITERAL_CONSTANT BOZ_LITERAL_CONSTANT }
protected-stmt	{ ENTRY FORMAT PARAMETER PROCEDURE 'TYPE' 'CLASS' NAME_LITERAL ENUM INTERFACE ABSTRACT_INTERFACE PUBLIC PRIVATE ALLOCATABLE ASYNCHRONOUS BIND CODIMENSION COMMON DATA DIMENSION EQUIVALENCE EXTERNAL INTENT INTRINSIC NAMELIST OPTIONAL POINTER PROTECTED SAVE TARGET VOLATILE VALUE INTEGER REAL DOUBLE_PRECISION COMPLEX CHARACTER LOGICAL }
97_opt_autogen	{ SELECT }
143_group_autogen	{ ',' }
target-decl-list	{ ENTRY FORMAT PARAMETER PROCEDURE 'TYPE' 'CLASS' NAME_LITERAL ENUM INTERFACE ABSTRACT_INTERFACE PUBLIC PRIVATE ALLOCATABLE ASYNCHRONOUS BIND CODIMENSION COMMON DATA DIMENSION EQUIVALENCE EXTERNAL INTENT INTRINSIC NAMELIST OPTIONAL POINTER PROTECTED SAVE TARGET VOLATILE VALUE INTEGER REAL DOUBLE_PRECISION COMPLEX CHARACTER LOGICAL }
use-stmt	{ USE }
187_group_autogen	{ }
17_opt_autogen	{ NAME_LITERAL }
end-function-stmt	{ FORMAT ENTRY DATA ALLOCATE NAME_LITERAL BACKSPACE CALL CLOSE CONTINUE CYCLE DEALLOCATE END ENDFILE ERROR_STOP EXIT FLUSH FORALL GO_TO IF INQUIRE LOCK NULLIFY OPEN PRINT READ RETURN REWIND STOP SYNC_ALL SYNC_IMAGES SYNC_MEMORY UNLOCK WAIT WHERE WRITE INT_LITERAL_CONSTANT REAL_LITERAL_CONSTANT COMPLEX_LITERAL_CONSTANT LOGICAL_LITERAL_CONSTANT CHAR_LITERAL_CONSTANT BOZ_LITERAL_CONSTANT MODULE 'TYPE' 'CLASS' ELEMENTAL IMPURE PURE RECURSIVE INTEGER REAL DOUBLE_PRECISION COMPLEX CHARACTER LOGICAL END_INTERFACE PROGRAM SUBMODULE BLOCK_DATA MODULE_PROCEDURE }
25_group_autogen	{ ',' }
109_opt_autogen	{ INT_LITERAL_CONSTANT '*' }
array-constructor	{ }
proc-component-attr-spec	{ ':' }
print-stmt	{ FORMAT ENTRY DATA ALLOCATE NAME_LITERAL BACKSPACE CALL CLOSE CONTINUE CYCLE DEALLOCATE END ENDFILE ERROR_STOP EXIT FLUSH FORALL GO_TO IF INQUIRE LOCK NULLIFY OPEN PRINT READ RETURN REWIND STOP SYNC_ALL SYNC_IMAGES SYNC_MEMORY UNLOCK WAIT WHERE WRITE INT_LITERAL_CONSTANT REAL_LITERAL_CONSTANT COMPLEX_LITERAL_CONSTANT LOGICAL_LITERAL_CONSTANT CHAR_LITERAL_CONSTANT BOZ_LITERAL_CONSTANT }
15_opt_autogen	{ ':' }
interface-stmt	{ }
22_optlist_autogen	{ ',' }
part-ref	{ '%' '(' }
proc-interface1_opt_autogen	{ ')' }
block-construct	{ FORMAT ENTRY DATA ALLOCATE NAME_LITERAL BACKSPACE CALL CLOSE CONTINUE CYCLE DEALLOCATE END ENDFILE ERROR_STOP EXIT FLUSH FORALL GO_TO IF INQUIRE LOCK NULLIFY OPEN PRINT READ RETURN REWIND STOP SYNC_ALL SYNC_IMAGES SYNC_MEMORY UNLOCK WAIT WHERE WRITE INT_LITERAL_CONSTANT REAL_LITERAL_CONSTANT COMPLEX_LITERAL_CONSTANT LOGICAL_LITERAL_CONSTANT CHAR_LITERAL_CONSTANT BOZ_LITERAL_CONSTANT }
171_group_autogen	{ }
where-assignment-stmt	{ FORMAT ENTRY DATA ALLOCATE NAME_LITERAL BACKSPACE CALL CLOSE CONTINUE CYCLE DEALLOCATE END ENDFILE ERROR_STOP EXIT FLUSH FORALL GO_TO IF INQUIRE LOCK NULLIFY OPEN PRINT READ RETURN REWIND STOP SYNC_ALL SYNC_IMAGES SYNC_MEMORY UNLOCK WAIT WHERE WRITE INT_LITERAL_CONSTANT REAL_LITERAL_CONSTANT COMPLEX_LITERAL_CONSTANT LOGICAL_LITERAL_CONSTANT CHAR_LITERAL_CONSTANT BOZ_LITERAL_CONSTANT }
10_optlist_autogen	{ ',' ')' }
goto-stmt	{ FORMAT ENTRY DATA ALLOCATE NAME_LITERAL BACKSPACE CALL CLOSE CONTINUE CYCLE DEALLOCATE END ENDFILE ERROR_STOP EXIT FLUSH FORALL GO_TO IF INQUIRE LOCK NULLIFY OPEN PRINT READ RETURN REWIND STOP SYNC_ALL SYNC_IMAGES SYNC_MEMORY UNLOCK WAIT WHERE WRITE INT_LITERAL_CONSTANT REAL_LITERAL_CONSTANT COMPLEX_LITERAL_CONSTANT LOGICAL_LITERAL_CONSTANT CHAR_LITERAL_CONSTANT BOZ_LITERAL_CONSTANT }
component-decl-list	{ 'TYPE' 'CLASS' PROCEDURE INTEGER REAL DOUBLE_PRECISION COMPLEX CHARACTER LOGICAL }
component-attr-spec-list	{ }
forall-triplet-spec	{ ',' }
NAME_LITERAL22_opt_autogen	{ FORMAT ENTRY DATA ALLOCATE NAME_LITERAL BACKSPACE CALL CLOSE CONTINUE CYCLE DEALLOCATE END ENDFILE ERROR_STOP EXIT FLUSH FORALL GO_TO IF INQUIRE LOCK NULLIFY OPEN PRINT READ RETURN REWIND STOP SYNC_ALL SYNC_IMAGES SYNC_MEMORY UNLOCK WAIT WHERE WRITE INT_LITERAL_CONSTANT REAL_LITERAL_CONSTANT COMPLEX_LITERAL_CONSTANT LOGICAL_LITERAL_CONSTANT CHAR_LITERAL_CONSTANT BOZ_LITERAL_CONSTANT }
13_optlist_autogen	{ ',' '/' ']' }
level-2-expr1_opt_autogen	{ '+' '-' }
98_group_autogen	{ NAME_LITERAL }
32_opt_autogen	{ }
17_optlist_autogen	{ }
input-item	{ }
assumed-shape-spec	{ ')' }
proc-language-binding-spec2_opt_autogen	{ }
section-subscript	{ ')' }
data-stmt-object	{ '/' }
proc-component-ref	{ '=' FORMAT ENTRY DATA ALLOCATE NAME_LITERAL BACKSPACE CALL CLOSE CONTINUE CYCLE DEALLOCATE END ENDFILE ERROR_STOP EXIT FLUSH FORALL GO_TO IF INQUIRE LOCK NULLIFY OPEN PRINT READ RETURN REWIND STOP SYNC_ALL SYNC_IMAGES SYNC_MEMORY UNLOCK WAIT WHERE WRITE INT_LITERAL_CONSTANT REAL_LITERAL_CONSTANT COMPLEX_LITERAL_CONSTANT LOGICAL_LITERAL_CONSTANT CHAR_LITERAL_CONSTANT BOZ_LITERAL_CONSTANT '(' }
58_opt_autogen	{ }
specification-part10_opt_autogen	{ ALLOCATE NAME_LITERAL BACKSPACE CALL CLOSE CONTINUE CYCLE DEALLOCATE END ENDFILE ERROR_STOP EXIT FLUSH FORALL GO_TO IF INQUIRE LOCK NULLIFY OPEN PRINT READ RETURN REWIND STOP SYNC_ALL SYNC_IMAGES SYNC_MEMORY UNLOCK WAIT WHERE WRITE INT_LITERAL_CONSTANT REAL_LITERAL_CONSTANT COMPLEX_LITERAL_CONSTANT LOGICAL_LITERAL_CONSTANT CHAR_LITERAL_CONSTANT BOZ_LITERAL_CONSTANT }
pointer-object	{ ')' }
elsewhere-stmt	{ }
io-unit	{ }
42_optlist_autogen	{ ',' ENTRY FORMAT PARAMETER PROCEDURE 'TYPE' 'CLASS' NAME_LITERAL ENUM INTERFACE ABSTRACT_INTERFACE PUBLIC PRIVATE ALLOCATABLE ASYNCHRONOUS BIND CODIMENSION COMMON DATA DIMENSION EQUIVALENCE EXTERNAL INTENT INTRINSIC NAMELIST OPTIONAL POINTER PROTECTED SAVE TARGET VOLATILE VALUE INTEGER REAL DOUBLE_PRECISION COMPLEX CHARACTER LOGICAL }
or-operand	{ AND OR }
8_group_autogen	{ ',' }
submodule-stmt	{ }
18_group_autogen	{ }
222_group_autogen	{ }
201_group_autogen	{ }
component-data-source	{ }
161_group_autogen	{ ',' }
cycle-stmt	{ FORMAT ENTRY DATA ALLOCATE NAME_LITERAL BACKSPACE CALL CLOSE CONTINUE CYCLE DEALLOCATE END ENDFILE ERROR_STOP EXIT FLUSH FORALL GO_TO IF INQUIRE LOCK NULLIFY OPEN PRINT READ RETURN REWIND STOP SYNC_ALL SYNC_IMAGES SYNC_MEMORY UNLOCK WAIT WHERE WRITE INT_LITERAL_CONSTANT REAL_LITERAL_CONSTANT COMPLEX_LITERAL_CONSTANT LOGICAL_LITERAL_CONSTANT CHAR_LITERAL_CONSTANT BOZ_LITERAL_CONSTANT }
allocate-object	{ '(' ',' }
import-stmt1_optlist_autogen	{ IMPORT }
sync-images-stmt	{ FORMAT ENTRY DATA ALLOCATE NAME_LITERAL BACKSPACE CALL CLOSE CONTINUE CYCLE DEALLOCATE END ENDFILE ERROR_STOP EXIT FLUSH FORALL GO_TO IF INQUIRE LOCK NULLIFY OPEN PRINT READ RETURN REWIND STOP SYNC_ALL SYNC_IMAGES SYNC_MEMORY UNLOCK WAIT WHERE WRITE INT_LITERAL_CONSTANT REAL_LITERAL_CONSTANT COMPLEX_LITERAL_CONSTANT LOGICAL_LITERAL_CONSTANT CHAR_LITERAL_CONSTANT BOZ_LITERAL_CONSTANT }
77_optlist_autogen	{ ',' ':' }
44_group_autogen	{ ')' }
sign1_opt_autogen	{ INT_LITERAL_CONSTANT }
221_group_autogen	{ ',' }
allocatable-decl	{ ENTRY FORMAT PARAMETER PROCEDURE 'TYPE' 'CLASS' NAME_LITERAL ENUM INTERFACE ABSTRACT_INTERFACE PUBLIC PRIVATE ALLOCATABLE ASYNCHRONOUS BIND CODIMENSION COMMON DATA DIMENSION EQUIVALENCE EXTERNAL INTENT INTRINSIC NAMELIST OPTIONAL POINTER PROTECTED SAVE TARGET VOLATILE VALUE INTEGER REAL DOUBLE_PRECISION COMPLEX CHARACTER LOGICAL }
147_group_autogen	{ CRITICAL }
block	{ END_ASSOCIATE END_BLOCK END_CRITICAL END_DO CONTINUE }
component-spec	{ ')' }
108_group_autogen	{ NAME_LITERAL }
component-part	{ CONTAINS }
output-item-list	{ FORMAT ENTRY DATA ALLOCATE NAME_LITERAL BACKSPACE CALL CLOSE CONTINUE CYCLE DEALLOCATE END ENDFILE ERROR_STOP EXIT FLUSH FORALL GO_TO IF INQUIRE LOCK NULLIFY OPEN PRINT READ RETURN REWIND STOP SYNC_ALL SYNC_IMAGES SYNC_MEMORY UNLOCK WAIT WHERE WRITE INT_LITERAL_CONSTANT REAL_LITERAL_CONSTANT COMPLEX_LITERAL_CONSTANT LOGICAL_LITERAL_CONSTANT CHAR_LITERAL_CONSTANT BOZ_LITERAL_CONSTANT }
NAME_LITERAL2_opt_autogen	{ '/' }
end-if-stmt	{ FORMAT ENTRY DATA ALLOCATE NAME_LITERAL BACKSPACE CALL CLOSE CONTINUE CYCLE DEALLOCATE END ENDFILE ERROR_STOP EXIT FLUSH FORALL GO_TO IF INQUIRE LOCK NULLIFY OPEN PRINT READ RETURN REWIND STOP SYNC_ALL SYNC_IMAGES SYNC_MEMORY UNLOCK WAIT WHERE WRITE INT_LITERAL_CONSTANT REAL_LITERAL_CONSTANT COMPLEX_LITERAL_CONSTANT LOGICAL_LITERAL_CONSTANT CHAR_LITERAL_CONSTANT BOZ_LITERAL_CONSTANT }
label-do-stmt	{ }
execution-part2_opt_autogen	{ CONTAINS }
65_group_autogen	{ ',' }
37_group_autogen	{ }
15_group_autogen	{ '*' }
117_group_autogen	{ }
62_group_autogen	{ ',' }
add-op	{ }
139_group_autogen	{ FORALL }
110_opt_autogen	{ NAME_LITERAL }
84_group_autogen	{ NAME_LITERAL '/' }
module	{ PROGRAM MODULE SUBMODULE BLOCK_DATA 'TYPE' 'CLASS' ELEMENTAL IMPURE PURE RECURSIVE INTEGER REAL DOUBLE_PRECISION COMPLEX CHARACTER LOGICAL }
30_optlist_autogen	{ ',' '/' }
enumerator-list	{ ENUMERATOR END_ENUM }
26_optlist_autogen	{ ',' ENTRY FORMAT PARAMETER PROCEDURE 'TYPE' 'CLASS' NAME_LITERAL ENUM INTERFACE ABSTRACT_INTERFACE PUBLIC PRIVATE ALLOCATABLE ASYNCHRONOUS BIND CODIMENSION COMMON DATA DIMENSION EQUIVALENCE EXTERNAL INTENT INTRINSIC NAMELIST OPTIONAL POINTER PROTECTED SAVE TARGET VOLATILE VALUE INTEGER REAL DOUBLE_PRECISION COMPLEX CHARACTER LOGICAL }
allocation	{ ',' }
specification-part4_opt_autogen	{ CONTAINS }
lock-stat	{ }
5_group_autogen	{ '*' ':' }
subscript-triplet	{ }
type-bound-proc-decl-list	{ PROCEDURE GENERIC FINAL }
subscript1_opt_autogen	{ ':' }
intent-stmt	{ ENTRY FORMAT PARAMETER PROCEDURE 'TYPE' 'CLASS' NAME_LITERAL ENUM INTERFACE ABSTRACT_INTERFACE PUBLIC PRIVATE ALLOCATABLE ASYNCHRONOUS BIND CODIMENSION COMMON DATA DIMENSION EQUIVALENCE EXTERNAL INTENT INTRINSIC NAMELIST OPTIONAL POINTER PROTECTED SAVE TARGET VOLATILE VALUE INTEGER REAL DOUBLE_PRECISION COMPLEX CHARACTER LOGICAL }
char-selector1_opt_autogen	{ ')' ':' ',' '(' }
interface-block	{ ENTRY FORMAT PARAMETER PROCEDURE 'TYPE' 'CLASS' NAME_LITERAL ENUM INTERFACE ABSTRACT_INTERFACE PUBLIC PRIVATE ALLOCATABLE ASYNCHRONOUS BIND CODIMENSION COMMON DATA DIMENSION EQUIVALENCE EXTERNAL INTENT INTRINSIC NAMELIST OPTIONAL POINTER PROTECTED SAVE TARGET VOLATILE VALUE INTEGER REAL DOUBLE_PRECISION COMPLEX CHARACTER LOGICAL }
113_opt_autogen	{ }
enumerator-def-stmt1_optlist_autogen	{ ENUMERATOR END_ENUM }
80_opt_autogen	{ }
action-stmt	{ FORMAT ENTRY DATA ALLOCATE NAME_LITERAL BACKSPACE CALL CLOSE CONTINUE CYCLE DEALLOCATE END ENDFILE ERROR_STOP EXIT FLUSH FORALL GO_TO IF INQUIRE LOCK NULLIFY OPEN PRINT READ RETURN REWIND STOP SYNC_ALL SYNC_IMAGES SYNC_MEMORY UNLOCK WAIT WHERE WRITE INT_LITERAL_CONSTANT REAL_LITERAL_CONSTANT COMPLEX_LITERAL_CONSTANT LOGICAL_LITERAL_CONSTANT CHAR_LITERAL_CONSTANT BOZ_LITERAL_CONSTANT }
208_group_autogen	{ }
implied-shape-spec-list	{ ')' }
81_group_autogen	{ }
deferred-coshape-spec-list	{ ']' }
loop-control2_opt_autogen	{ }
internal-subprogram-part	{ END }
derived-type-stmt	{ }
204_group_autogen	{ }
51_group_autogen	{ ',' }
data-stmt-object-list	{ '/' }
dealloc-opt	{ }
2_opt_autogen	{ }
119_group_autogen	{ }
sync-memory-stmt	{ FORMAT ENTRY DATA ALLOCATE NAME_LITERAL BACKSPACE CALL CLOSE CONTINUE CYCLE DEALLOCATE END ENDFILE ERROR_STOP EXIT FLUSH FORALL GO_TO IF INQUIRE LOCK NULLIFY OPEN PRINT READ RETURN REWIND STOP SYNC_ALL SYNC_IMAGES SYNC_MEMORY UNLOCK WAIT WHERE WRITE INT_LITERAL_CONSTANT REAL_LITERAL_CONSTANT COMPLEX_LITERAL_CONSTANT LOGICAL_LITERAL_CONSTANT CHAR_LITERAL_CONSTANT BOZ_LITERAL_CONSTANT }
37_optlist_autogen	{ ',' ')' }
inquire-stmt	{ FORMAT ENTRY DATA ALLOCATE NAME_LITERAL BACKSPACE CALL CLOSE CONTINUE CYCLE DEALLOCATE END ENDFILE ERROR_STOP EXIT FLUSH FORALL GO_TO IF INQUIRE LOCK NULLIFY OPEN PRINT READ RETURN REWIND STOP SYNC_ALL SYNC_IMAGES SYNC_MEMORY UNLOCK WAIT WHERE WRITE INT_LITERAL_CONSTANT REAL_LITERAL_CONSTANT COMPLEX_LITERAL_CONSTANT LOGICAL_LITERAL_CONSTANT CHAR_LITERAL_CONSTANT BOZ_LITERAL_CONSTANT }
end-associate-stmt	{ FORMAT ENTRY DATA ALLOCATE NAME_LITERAL BACKSPACE CALL CLOSE CONTINUE CYCLE DEALLOCATE END ENDFILE ERROR_STOP EXIT FLUSH FORALL GO_TO IF INQUIRE LOCK NULLIFY OPEN PRINT READ RETURN REWIND STOP SYNC_ALL SYNC_IMAGES SYNC_MEMORY UNLOCK WAIT WHERE WRITE INT_LITERAL_CONSTANT REAL_LITERAL_CONSTANT COMPLEX_LITERAL_CONSTANT LOGICAL_LITERAL_CONSTANT CHAR_LITERAL_CONSTANT BOZ_LITERAL_CONSTANT }
20_optlist_autogen	{ ',' ')' }
end-type-stmt	{ ENTRY FORMAT PARAMETER PROCEDURE 'TYPE' 'CLASS' NAME_LITERAL ENUM INTERFACE ABSTRACT_INTERFACE PUBLIC PRIVATE ALLOCATABLE ASYNCHRONOUS BIND CODIMENSION COMMON DATA DIMENSION EQUIVALENCE EXTERNAL INTENT INTRINSIC NAMELIST OPTIONAL POINTER PROTECTED SAVE TARGET VOLATILE VALUE INTEGER REAL DOUBLE_PRECISION COMPLEX CHARACTER LOGICAL }
language-binding-spec	{ ':' NAME_LITERAL RESULT }
179_group_autogen	{ ',' }
70_optlist_autogen	{ ',' ')' }
enum-def-stmt	{ ENUMERATOR }
bounds-remapping	{ ')' }
type-guard-stmt	{ }
stmt-function-stmt	{ ENTRY FORMAT PARAMETER PROCEDURE 'TYPE' 'CLASS' NAME_LITERAL ENUM INTERFACE ABSTRACT_INTERFACE PUBLIC PRIVATE ALLOCATABLE ASYNCHRONOUS BIND CODIMENSION COMMON DATA DIMENSION EQUIVALENCE EXTERNAL INTENT INTRINSIC NAMELIST OPTIONAL POINTER PROTECTED SAVE TARGET VOLATILE VALUE INTEGER REAL DOUBLE_PRECISION COMPLEX CHARACTER LOGICAL }
','8_opt_autogen	{ }
char-selector	{ }
external-subprogram	{ PROGRAM MODULE SUBMODULE BLOCK_DATA 'TYPE' 'CLASS' ELEMENTAL IMPURE PURE RECURSIVE INTEGER REAL DOUBLE_PRECISION COMPLEX CHARACTER LOGICAL }
alloc-opt	{ }
level-1-expr	{ '*' }
140_opt_autogen	{ NAME_LITERAL '*' INT_LITERAL_CONSTANT REAL_LITERAL_CONSTANT COMPLEX_LITERAL_CONSTANT LOGICAL_LITERAL_CONSTANT CHAR_LITERAL_CONSTANT BOZ_LITERAL_CONSTANT }
char-literal-constant1_opt_autogen	{ '(' ',' ')' }
w1_opt_autogen	{ ',' ')' }
concat-op	{ }
39_group_autogen	{ '[' }
module-subprogram	{ MODULE_PROCEDURE 'TYPE' 'CLASS' ELEMENTAL IMPURE MODULE PURE RECURSIVE INTEGER REAL DOUBLE_PRECISION COMPLEX CHARACTER LOGICAL }
90_opt_autogen	{ CRITICAL }
87_group_autogen	{ '[' }
68_optlist_autogen	{ ',' }
137_group_autogen	{ END_WHERE }
123_group_autogen	{ ',' }
final-procedure-stmt	{ PROCEDURE GENERIC FINAL }
shared-term-do-construct	{ FORMAT ENTRY DATA ALLOCATE NAME_LITERAL BACKSPACE CALL CLOSE CONTINUE CYCLE DEALLOCATE END ENDFILE ERROR_STOP EXIT FLUSH FORALL GO_TO IF INQUIRE LOCK NULLIFY OPEN PRINT READ RETURN REWIND STOP SYNC_ALL SYNC_IMAGES SYNC_MEMORY UNLOCK WAIT WHERE WRITE INT_LITERAL_CONSTANT REAL_LITERAL_CONSTANT COMPLEX_LITERAL_CONSTANT LOGICAL_LITERAL_CONSTANT CHAR_LITERAL_CONSTANT BOZ_LITERAL_CONSTANT }
named-constant-def	{ ')' }
107_group_autogen	{ ',' }
lock-stat-list	{ }
enum-def	{ ENTRY FORMAT PARAMETER PROCEDURE 'TYPE' 'CLASS' NAME_LITERAL ENUM INTERFACE ABSTRACT_INTERFACE PUBLIC PRIVATE ALLOCATABLE ASYNCHRONOUS BIND CODIMENSION COMMON DATA DIMENSION EQUIVALENCE EXTERNAL INTENT INTRINSIC NAMELIST OPTIONAL POINTER PROTECTED SAVE TARGET VOLATILE VALUE INTEGER REAL DOUBLE_PRECISION COMPLEX CHARACTER LOGICAL }
execution-part-construct3_optlist_autogen	{ FORMAT ENTRY DATA ALLOCATE NAME_LITERAL BACKSPACE CALL CLOSE CONTINUE CYCLE DEALLOCATE END ENDFILE ERROR_STOP EXIT FLUSH FORALL GO_TO IF INQUIRE LOCK NULLIFY OPEN PRINT READ RETURN REWIND STOP SYNC_ALL SYNC_IMAGES SYNC_MEMORY UNLOCK WAIT WHERE WRITE INT_LITERAL_CONSTANT REAL_LITERAL_CONSTANT COMPLEX_LITERAL_CONSTANT LOGICAL_LITERAL_CONSTANT CHAR_LITERAL_CONSTANT BOZ_LITERAL_CONSTANT }
image-selector1_opt_autogen	{ '%' '(' }
return-stmt	{ FORMAT ENTRY DATA ALLOCATE NAME_LITERAL BACKSPACE CALL CLOSE CONTINUE CYCLE DEALLOCATE END ENDFILE ERROR_STOP EXIT FLUSH FORALL GO_TO IF INQUIRE LOCK NULLIFY OPEN PRINT READ RETURN REWIND STOP SYNC_ALL SYNC_IMAGES SYNC_MEMORY UNLOCK WAIT WHERE WRITE INT_LITERAL_CONSTANT REAL_LITERAL_CONSTANT COMPLEX_LITERAL_CONSTANT LOGICAL_LITERAL_CONSTANT CHAR_LITERAL_CONSTANT BOZ_LITERAL_CONSTANT }
NAME_LITERAL14_opt_autogen	{ }
access-id-list	{ NAME_LITERAL OPERATOR ASSIGNMENT READ WRITE }
166_group_autogen	{ ')' }
74_opt_autogen	{ }
29_optlist_autogen	{ ',' }
74_group_autogen	{ ',' }
image-set	{ ',' }
power-op	{ '.' }
dimension-spec	{ }
20_opt_autogen	{ NAME_LITERAL INT_LITERAL_CONSTANT REAL_LITERAL_CONSTANT COMPLEX_LITERAL_CONSTANT LOGICAL_LITERAL_CONSTANT CHAR_LITERAL_CONSTANT BOZ_LITERAL_CONSTANT }
type-param-def-stmt1_optlist_autogen	{ INTEGER }
150_group_autogen	{ }
133_opt_autogen	{ PROGRAM MODULE SUBMODULE BLOCK_DATA 'TYPE' 'CLASS' ELEMENTAL IMPURE PURE RECURSIVE INTEGER REAL DOUBLE_PRECISION COMPLEX CHARACTER LOGICAL }
101_opt_autogen	{ FORMAT ENTRY DATA ALLOCATE NAME_LITERAL BACKSPACE CALL CLOSE CONTINUE CYCLE DEALLOCATE END ENDFILE ERROR_STOP EXIT FLUSH FORALL GO_TO IF INQUIRE LOCK NULLIFY OPEN PRINT READ RETURN REWIND STOP SYNC_ALL SYNC_IMAGES SYNC_MEMORY UNLOCK WAIT WHERE WRITE INT_LITERAL_CONSTANT REAL_LITERAL_CONSTANT COMPLEX_LITERAL_CONSTANT LOGICAL_LITERAL_CONSTANT CHAR_LITERAL_CONSTANT BOZ_LITERAL_CONSTANT }
pointer-object-list	{ ')' }
1_group_autogen	{ ',' }
_START_	{ _FINISH_ }
else-stmt	{ }
151_group_autogen	{ ELSE_IF ELSE }
NAME_LITERAL11_opt_autogen	{ FORMAT ENTRY DATA ALLOCATE NAME_LITERAL BACKSPACE CALL CLOSE CONTINUE CYCLE DEALLOCATE END ENDFILE ERROR_STOP EXIT FLUSH FORALL GO_TO IF INQUIRE LOCK NULLIFY OPEN PRINT READ RETURN REWIND STOP SYNC_ALL SYNC_IMAGES SYNC_MEMORY UNLOCK WAIT WHERE WRITE INT_LITERAL_CONSTANT REAL_LITERAL_CONSTANT COMPLEX_LITERAL_CONSTANT LOGICAL_LITERAL_CONSTANT CHAR_LITERAL_CONSTANT BOZ_LITERAL_CONSTANT }
78_opt_autogen	{ }
123_opt_autogen	{ ',' ')' }
proc-decl-list	{ 'TYPE' 'CLASS' PROCEDURE INTEGER REAL DOUBLE_PRECISION COMPLEX CHARACTER LOGICAL ENTRY FORMAT PARAMETER NAME_LITERAL ENUM INTERFACE ABSTRACT_INTERFACE PUBLIC PRIVATE ALLOCATABLE ASYNCHRONOUS BIND CODIMENSION COMMON DATA DIMENSION EQUIVALENCE EXTERNAL INTENT INTRINSIC NAMELIST OPTIONAL POINTER PROTECTED SAVE TARGET VOLATILE VALUE }
